abandon=vt.放棄
absorb=vt.吸收
abundance=n.豐富,充足
abundant=adj.豐富的
accident=n.意外事件
accommodate=vt.容納
accomplishment=n.成就
accuracy=n.正確性
accurate=adj.正確的
achievement=n.成就
acquaintance=n.熟悉
add=vt.加
addition=n.加
admirable=adj.可稱讚的
admire=vt.稱讚,欽佩
advance=n.前進
advantage=n.利益,佔便宜
advertisement=n.廣告
advice=n.忠告
affect=vt.影響
afford=vt.能夠,負擔得起
agriculture=n.農業
alcohol=n.酒精
allowance=n.津貼
alphabet=n.字母
altitude=n.高度
amateur=adj.業餘的
ambassador=n.大使
ambulance=n.救護車
amplify=vt.擴大(聲音)
analysis=n.分析
ancestor=n.祖先
ancient=adj.古代的
anxiety=n.焦慮
anxious=adj.焦慮的
apologize=vi.道歉
apology=n.道歉
appearance=n.外表,出現
appetite=n.食慾
appliance=n.器具
applicant=n.申請人
application=n.申請,應用
apply=vi.申請,應用
appointment=n.約會
appreciate=vt.欣賞,感激
architect=n.建築師
arrange=vt.安排,排列
arrangement=n.安排,排列
arrival=n.到達
artificial=adj.人造的
assemble=vt.集合,裝配
assembly=vt.集合,裝配
assignment=n.指定作業
assistant=n.助手
associate=vi.結交
assurance=n.保證,保險
astonishment=n.驚奇
astronaut=n.太空人
athlete=n.運動員
atmosphere=n.大氣
atom=n.原子
atomic=adj.原子的
attack=vt.攻擊
attendance=n.出席
attitude=n.態度
attract=vt.吸引
attractive=adj.吸引人的
authority=n.權威
autobiography=n.自傳
automatically=adv.自動地
automobile=n.汽車
available=adj.可用的
average=n.平均,平均的
award=vt.授與,獎品
background=n.背景
balance=n.平衡
bankrupt=adj.破產的
bankruptcy=n.破產
barber=n.理髮師
bargain=n.交易,便宜貨
basement=n.地下室
battery=n.電池
behavior=n.行為
benefit=n.利益,得到利益
biography=n.傳記
blacksmith=n.鐵匠
boundary=n.疆界
bravery=n.勇敢
brilliant=adj.燦爛的
broadcast=vt.廣播
bullet=n.子彈
butcher=n.屠夫
cafeteria=n.自助餐廳
calculate=vt.計算
calendar=n.日曆
cancel=vt.取消
cancer=n.癌
candidate=n.候選人
candle=n.蠟燭
capable=adj.有能力的
capital=n.資本,首都
carpenter=n.木匠
cashier=n.出納員
catalogue=n.目錄
celebrate=vt.慶祝
celebration=n.慶祝
central=adj.中央的
century=n.世紀
ceremony=n.儀式
champion=n.冠軍
character=n.品格,人物
chemistry=n.化學
chief=n.首長,首領
choice=n.選擇
circulate=vt.循環
circulation=n.循環
citizen=n.公民
civilization=n.文明
climate=n.氣候
collect=vt.收集
comfort=n.舒適,安慰
comfortable=adj.舒服的
commerce=n.商業
commission=n.佣金
committee=n.委員會
communicate=vi.溝通,聯絡;vt.傳達
communication=n.通信,交通
community=n.社區
compare=vt.比較
comparison=n.比較
compensate=vi.補償
compensation=n.賠償
compete=vt.競爭,角逐
competent=adj.勝任的
competition=n.競爭
complicated=adj.複雜的
compromise=vt.妥協,和解
compulsory=adj.強迫的
conceal=n.隱藏
concentrate=vt.集中
concert=n.音樂會
conclude=n.下結論
conclusion=n.結論
concrete=n.混凝土
condition=n.情況,條件
conductor=n.車掌,車長
confidence=n.信心
confident=adj.自信的
confuse=vt.使困惑
confusion=n.混亂,困惑
connect=vt.連接
conquer=vt.征服
conquest=n.征服
consent=vt.同意
consequence=n.結果,影響
considerate=adj.體貼的
consideration=n.考慮
construct=vt.建造
construction=n.建造
constructive=adj.建設的
consult=vt.請教,商量
consume=vt.消費
consumption=n.消費
contact=n.接觸
contain=vt.包含
continent=n.洲,大陸
continue=vi.繼續
contract=n.合同;vt.收縮
contrary=adj.相反的
contrast=n.對比,對照
contribute=vt.貢獻
contribution=n.貢獻
control=vt.控制
convenient=adj.方便的
cooperate=vt.合作
cooperative=adj.合作的
correct=adj.正確的,改正
correspond=n.通信
correspondent=n.通信員
cotton=n.棉花
courage=n.勇氣
courageous=adj.勇敢的
courtesy=n.禮節
create=vt.創造
creature=n.動物,生物
credit=n.信用,光榮
criminal=n.犯罪者(犯罪的)
crisis=n.危機
critic=n.評論家,抨擊者
criticism=n.批評
criticize=vt.批評
cultivate=vt.培養,耕種
culture=n.文化
curiosity=n.好奇
curious=adj.好奇的
curtain=n.幕,窗帘
custom=n.習慣
customary=adj.習慣的
customer=n.顧客
damage=n.傷害
decade=n.十年
decay=vi.腐蝕,敗壞
decision=n.決定
decorate=vt.裝飾
decoration=n.裝飾
decrease=vi.減少
defend=vt.保衛
defense=n.防衛
definite=adj.明確的
delay=vi.耽擱,延遲
delicious=adj.美味的
deliver=vt.遞送
delivery=n.遞送
democracy=n.民主
demonstrate=vt.示範
dentist=n.牙醫
dependable=adj.可靠的
deposit=vt.儲存
depress=vt.降低,使沮喪
depression=n.沮喪,不景氣
deprive=vt.剝奪
description=n.描述,形容
desert=n.沙漠,遺棄
design=vt.設計
despair=n.失望
dessert=n.餐後甜點
destination=n.目的地
destructive=adj.破壞的
detail=n.細節
detective=n.偵探
determine=vt.決意
development=n.發展
diamond=n.鑽石
difficulty=n.困難
diligence=n.用功
diligent=adj.用功的
diminish=vt.減少
diploma=n.畢業證書
direction=n.方向
disadvantage=n.不利,吃虧
discard=vt.拋棄
discount=n.折扣
discover=vt.發現
discovery=n.發現
discuss=vt.討論
discussion=n.討論
disgust=vt.令人討厭
dismiss=vt.開除
dissolve=vt.溶解
distinguish=vt.區別
distribute=vt.分配
disturb=vt.擾亂
division=n.除,分開
document=n.文件
domestic=adj.國內的,馴服的
double=adj.加倍(的)
earthquake=n.地震
economic=adj.經濟的
economical=adj.節省的
economics=n.經濟學
economy=n.節省,經濟
edible=adj.可吃的
educate=vt.教育
education=n.教育
effective=adj.有效的
efficiency=n.效率
efficient=adj.有效率的
effort=n.努力
elasticity=n.彈性
election=n.選擇
electric=adj.電的
electricity=n.電
electron=n.電子
element=n.要素
elevator=n.電梯
eliminate=vt.除去
eloquent=adj.雄辯的
emergency=n.緊急事件
emphasis=n.強調,重點
emphasize=vt.強調,注重
employ=vt.雇用
employee=n.員工
employer=n.雇主
employment=n.雇用
enclose=vt.附寄,圍繞
encourage=vt.鼓舞,激勵
endurance=n.忍受
endure=vt.忍受
energetic=adj.有精力的
energy=n.能源
engine=n.引擎
engineer=n.工程師
enterprise=n.企業
entertain=vt.款待
entertainment=n.娛樂
entrance=n.進口,入口
envelope=n.信封
environment=n.環境
equal=adj.平等的
equipment=n.設備
error=n.錯誤
especially=adv.尤其,特別地
essential=adj.必要的
evaporate=vi.蒸發
evidence=n.作證,證據
examination=n.考試,檢查
examine=vt.檢查
exceed=vt.超過
excel=vt.優於
excellent=adj.優秀的
exchange=vt.交換
excite=vt.使興奮
excitement=n.興奮
exercise=n.練習,運動
exhibit=vt.展覽
exist=vi.生存
existence=n.存在,生存
expand=vt.擴張
expense=n.費用
expensive=adj.昂貴的
experience=n.經驗
experiment=n.實驗
expert=n.專家
explode=vi.爆炸
exploration=n.探險
explore=vt.探險
explosion=n.爆炸(聲)
exporter=n.出口商
expose=vt.曝露
exposure=n.曝露
express=n.快車,表達
expression=n.表達
extinguish=vt.熄滅
failure=n.失敗
faithful=adj.忠實的
familiar=adj.熟悉的
fashion=n.式樣,時髦
favorite=adj.最喜歡的
feather=n.羽毛
feature=n.容貌
fertilizer=n.肥料
fever=n.發燒
financial=adj.財政的
fingerprint=n.指紋
flexible=adj.有伸縮性的
fluent=adj.流利的
formal=adj.正式的
fortunate=adj.幸運的
fortune=n.財富,幸運
foundation=n.基礎
freedom=n.自由
freeze=n.結冰
freight=n.貨物
frequently=adv.時常地
frighten=n.使害怕
fuel=n.燃料
fulfill=vt.履行
function=n.作用,功能
furnish=n.供應
furniture=n.傢俱
garage=n.車庫,修車廠
gasoline=n.汽油
generate=vt.產生
generation=n.產生,一代,世代
generator=n.發電機
generosity=n.慷慨
generous=n.慷慨的
genius=n.天才
genuine=adj.真正的
geography=n.地理
glitter=n.閃閃發光
globe=n.地球
glorious=n.光榮的
glory=n.光榮
government=n.政府
gradually=adv.漸漸地
graduate=vt.畢業
grammar=n.文法
grateful=n.感激的
gratitude=n.感激
gravity=n.萬有引力
grocer=n.雜貨商
guarantee=vt.保證
guide=n.嚮導,指南
guilty=adj.有罪的
habitual=adj.習慣的
harbor=n.港口
hardware=n.五金器具
harvest=n.收穫
hatch=n.孵化
helicopter=n.直升機
hesitate=vt.猶豫
horizon=n.地平線
humanity=n.人性,人類
humble=n.謙卑的
identical=adj.同一的
identify=n.認明
ignorance=n.無知
ignorant=adj.無知的
illiterate=n.文盲
illustrate=n.舉例說明
imaginary=adj.幻想的
imagination=n.想像力,幻想
imaginative=adj.富有想像力的
imitate=vt.模仿
imitation=n.模仿,仿造物
importer=n.進口商
impression=n.印象
impulse=n.衝動
inadequate=n.不充足的 
incline=n.傾向
include=n.包含
income=n.收入
increase=vi.增加
incredible=adj.難以置信的
independent=adj.獨立的
index=n.索引
indifferent=n.漠不關心
individual=adj.個人(的)
industrial=adj.工業的
industrious=adj.用功的
industry=n.工 ~
inevitable=adj.不可避免的
inferior=adj.劣的
influence=n.影響
inform=vt.通知
information=n.消息,情報
ingredient=n.成分
inhabitant=n.居民
inherit=vt.繼承
injure=n.傷害
innocence=n.天真無邪,清白
innocent=adj.無知的,天真的
insect=n.昆蟲
insecticide=n.殺蟲劑
inspection=n.調查
inspiration=n.靈感
instruction=n.指示,教導
instructive=n.有益的
instrument=n.儀器
insurance=n.保險
intelligent=n.有智力的,聰明
intention=n.企圖,意向
intentionally=n.故意地
interfere=vt.干涉
internal=n.內部的
interrupt=vt.打擾
interval=n.期間
interview=n.接見
intimate=adj.親密的
introduce=vt.介紹
introduction=n.介紹
invalid=adj.不健全的,無效的
invention=n.發明
inventor=n.發明家
invest=vt.投資
investigate=vt.調查
investigation=n.調查
investment=n.投資
invisible=n.看不見的
invitation=n.邀請
involve=n.包括,牽涉
irritate=vt.激怒
isolate=vt.孤立
isolation=n.孤立
issue=n.發行
jealous=adj.嫉妒的,羨慕的
journey=n.旅行
judgment=n.判斷
justice=n.正義
laboratory=n.實驗室
ladder=n.梯子
language=n.語言
lawyer=n.律師
leather=n.皮革
leisure=n.閒暇(的)
liberty=n.自由
librarian=n.圖書館員
license=n.執照
liquid=n.液體
literature=n.文學
liver=n.肝
local=n.地方的
location=n.地點,位置
luggage=n.行李
luxury=n.奢侈(品)
machinery=n.機器
magician=n.魔術師
magnet=n.磁石
magnetic=n.磁性的
maintain=n.保持
majority=n.多數
manager=n.經理
manual=n.手冊
manufacturer=n.製造商
marriage=n.結婚
massage=n.按摩
master=n.主人,精通
material=n.物質
mature=adj.成熟的
maximum=n.極大
measure=vt.測量
mechanic=n.技工
mechanical=adj.機械的
medal=n.獎牌
medical=adj.醫藥的
medium=n.媒介
memorize=vt.記憶
mental=n.精神
merchant=n.商人
message=n.訊息
messenger=n.報信者
metal=n.金屬
method=n.方法
microscope=n.顯微鏡
mineral=n.礦物
minimum=n.極小
minority=n.少數
miserable=adj.愁苦的
mission=n.任務
mixture=adj.混合的
model=n.模特兒,模式
monument=n.紀念碑
musician=n.音樂家
mutual=n.互相的
mystery=n.神秘
nation=n.國家
national=adj.國家的
native=n.本地人,本土
natural=adj.自然的
nature=n.自然,本性
navigate=n.駕駛
necessary=adj.必須的
necessity=n.需要
nervous=adj.神經緊張的
normal=adj.正常的
notice=n.注意,通知
nourish=vt.滋養
nuclear=adj.核子的
oasis=n.綠洲
obedient=adj.服從的
object=n.反對,受詞,目的
obligation=n.義務
observe=vt.觀察
obstacle=n.障礙(物)
obstinate=n.固劫執的
obvious=adj.明顯的
occasion=n.場合
occupation=n.職業
occupy=n.佔有,佔據
offend=vt.觸怒
official=adj.官員,官方的
omit=n.遺漏
operate=vt.操作,開刀
operator=n.接線生
opportunity=n.機會
opposite=adj.相反字,相反的
oppress=n.壓迫
oppression=n.壓迫
orbit=n.軌道
orchard=n.果園
ordinary=adj.普通的
organization=n.組織
organize=vt.組織
origin=n.開端,來源
original=adj.原先的,原文
ornament=n.裝飾品
orphan=n.孤兒
outline=n.大綱
output=n.結果
overcome=vt.克服
overlook=vi.俯瞰
parade=vi.遊行
participate=vi.參加
particle=n.微粒
particular=adj.特別的
passport=n.護照
pastime=n.消遣,娛樂
patent=n.專利權,專賣的
patient=n.病人
patriot=n.愛國者
patrol=n.巡邏
pearl=n.珍珠
pension=n.養老金
perfect=adj.完美的
perform=vt.表演,實行
performance=n.表演,實行
period=n.時期
permanent=n.永久的
permit=n.允許
personal=adj.個人的
personality=n.個性
personnel=n.人事,職員
petroleum=n.石油 
refrigerator=n.電冰箱
phenomenon=n.現象
philosopher=n.哲學家
philosophy=n.哲學
photograph=n.照片
photography=n.攝影
physical=adj.身體的,物理的
physician=n.內科醫生
physicist=n.物理學家
physics=n.物理學
pillow=n.枕頭
pilot=n.飛機駕駛員
planet=n.行星
plastic=n.塑膠,塑造的
pleasant=adj.令人愉快的
pleasure=n.樂趣
plumber=n.修理水管工人
poison=n.毒藥
policy=n.政策
polish=n.擦亮
polite=adj.有禮貌的
political=adj.政治的
politics=n.政治學
pollute=n.污染
pollution=n.污染
popularity=n.流行,聲望
population=n.人口
portable=adj.可攜帶的
possess=vt.擁有
possession=n.所有權,擁有
postpone=vt.延擱
poverty=n.貧窮
powerful=adj.有力量的
practical=adj.實際的
precious=adj.寶貴的
precise=adj.精確的
preferable=n.比較喜歡的
prescribe=vt.開藥方
prescription=n.藥方
president=n.總統
pressure=n.壓力
pretend=vt.假裝
prevail=n.流行
prevent=vt.防止
prevention=n.預防,阻止
principal=n.中學校長,主要的
principle=n.原理,主義
private=adj.私下的
process=n.過程
procession=n.行列
product=n.產品
production=n.生產
profession=n.專業
professional=adj.職業的
professor=n.教授
proficient=adj.精通的
profit=n.利潤
program=n.節目
progress=n.進步
promising=adj.有前途的
promote=vt.升遷,促進
pronounce=vt.發音
pronunciation=n.發音
property=n.財物
prosperity=n.繁榮
prosperous=adj.繁榮的,成功的
protect=vt.保護
province=n.省分
psychology=n.心理學
public=n.大眾,公立的
publication=n.出版
publish=vt.發行,刊登
publisher=n.發行人
punctual=adj.準時的
purchase=vt.購買
purity=n.純潔
purpose=n.目的
pursue=n.追逐
puzzle=vt.困惑,使困惑
qualify=n.使合格
quality=n.質
quantity=n.量
quarrel=n.爭吵
quarter=n.四分之一
realize=vt.了解,實現
reasonable=adj.合理的
receipt=n.收據
recognize=vt.認得
recommend=vt.推薦
recover=vi.恢復,痊癒
recreation=n.娛樂
reduce=n.減少
reference=n.參考
reflect=vt.反映,反射
refugee=n.難民
refuse=vt.拒絕
region=n.區域
register=vt.掛號,登記
regular=n.規律的
regulation=n.規則
relative=n.親戚
relax=n.放鬆
release=vt.釋放
reliable=adj.可靠的
relieve=vt.減輕,免除
religion=n.宗教
religious=adj.宗教的
remedy=n.治療(法)
remind=vt.提醒
repair=vt.修理
reporter=n.記者
represent=vt.代表
representative=n.代表
reputation=n.名聲
resemble=vt.像,相似
reservation=n.保留
resign=n.辭職
resist=n.抵抗
resistance=n.抵抗
resource=n.資源
respectable=n.令人尊敬的
respectful=n.表示尊敬的
respective=n.個別的
responsibility=n.責任
responsible=adj.有責任的
result=n.結果
retire=vi.退休
retiree=n.退休人員
retreat=n.撤退
revolution=n.革命
reward=n.酬勞
ridiculous=adj.可笑的
rocket=n.火箭
rubber=n.橡皮
rumor=n.謠傳
runway=n.跑道
sacrifice=vt.犧牲
safety=n.安全
salary=n.薪水
salesman=n.推鋗員
sample=n.樣品
satellite=n.衛星
satisfactory=adj.令人滿意的
scenery=n.風景
schedule=n.時間表
scholarship=n.獎學金
science=n.科學
scientific=adj.科學的
scientist=n.科學家
scissors=n.剪刀
secretary=n.秘書
security=n.安全
selfish=adj.自私的
serious=adj.嚴肅的
service=n.服務
shallow=n.淺的
shelter=n.避難所
shepherd=n.牧羊人
sidewalk=n.人行道
signature=n.簽名
similar=adj.相似的
simplify=vt.簡化
situation=n.位置,情勢
society=n.社會
solid=n.固體(的)
solution=n.解決,溶液
source=n.來源
souvenir=n.紀念品
spare=adj.剩餘的,省卻
specialist=n.專家
specific=adj.特殊的
specify=n.指定
spoil=vt.寵壞,損害
spread=vt.傳播,展開
standard=n.標準
statesman=n.政治家
stimulate=vt.鼓舞
stomach=n.胃
straight=n.直的
strength=n.力量,強壯
structure=n.結構
stubborn=adj.固執的
studio=n.工作室
stupid=adj.愚笨的
submarine=n.潛水艇
subscribe=vt.訂閱,捐助
subscription=n.訂閱,捐助
succeed=vi.成功
success=n.成功
sufficient=adj.充分的
suitable=n.適合的
superior=adj.優的
support=vt.支持
surgeon=n.外科醫生
surrender=vi.投降,屈服
survive=n.生還
survivor=n.生還者
swallow=n.吞,燕子
switch=n.開關
symbolize=vt.象徵
sympathy=n.同情
symptom=n.症狀
system=n.制度
tailor=n.裁縫
talkative=adj.愛講話的
technical=adj.技術的
technique=n.技術
technology=n.工藝,科技
telegram=n.電報
telescope=n.望遠鏡
televise=n.電視播送
temper=n.脾氣
temperate=n.溫和的
temperature=n.溫度
temporary=adj.暫時的
temptation=n.誘惑
terrible=adj.可怕的
territory=n.領土
textile=n.織物
theory=n.理論
thermometer=n.溫度計
threaten=n.威脅
tolerate=n.忍受;vt.忍受
transfer=n.遷移
translate=vt.翻譯
transmit=n.傳送,傳播
transport=vt.運輸
transportation=n.運輸
treatment=n.對待,治療,處理
triumph=n.勝利
tropical=adj.熱帶的
tunnel=n.隧道
typist=n.打字員
uniform=n.制服
universal=adj.宇宙的
universe=n.宇宙
university=n.大學
urgent=adj.緊急的
utilize=vt.利用
vacant=adj.空的
valuable=adj.有價值的
variety=n.各種不同,變化
various=adj.各種不同的
vehicle=n.車輛
vessel=n.器皿,艦
victim=n.受害者
victory=n.勝利
violent=adj.強烈的
virtue=n.美德
visible=adj.可看見的
vocabulary=n.字彙
vocation=n.職業
voluntary=adj.志願的
volunteer=n.志願者
wage=n.工資
waterproof=adj.防水的
weapon=n.武器
wedding=n.婚禮
wholesale=n.批發
wisdom=n.智慧
