wearing=衣着
clothes=衣服
suit=西装
buttons=钮扣
sportswear=运动服
pocket=口袋
pajamas=睡衣
zipper=拉链
nightwear=睡袍
cotton material=布料
casual wear=休闲服
material=质料
home clothing=家居服
silk=丝质
entire clothing=套装
cotton=棉质
children clothing=童装
nylon cloth=尼龙布
wedding=婚纱
waterproof=防水
overalls=工作服
windbreak=防风
uniform=制服
style=款式
jacket=上衣
try on clothes=试穿(衣服)
shirt=衬衫
color=颜色
white shirt=白衬衫
suit pants=西装裤
plaid shirt=格子衬衫
jeans=牛仔裤
polo shirt=polo衫
flares=喇叭裤
T-shirt=T恤
tight pants=紧身裤
sweater=毛衣
short pants=短裤
vest=背心
long pants=长裤
coat=外套
skirt=裙子
windbreaker=风衣
dress=连衣裙
high collar=高领
long skirt=长裙
round collar=园领
skirt=短裙
V-neck=V字领
narrow skirt=窄裙
short sleeve=短袖
mini skirt=迷你裙
long sleeve=长袖
culottes=裙裤
sleeveless=无袖
fancy=花色
single-breasted=单排扣
pants=裤子
double-breasted=双排扣
clothing accessories=衣服配件
tie=领带
hat=帽子
straw hat=草帽
baseball cap=棒球帽
scarf=围巾
cap=鸭舌帽
scarves=丝巾
leather belt=腰带,皮带
shawl=披肩
gloves=手套
handkerchief=手帕
jewelry=首饰
diamond=钻石
ring=戒指
gem=宝石
necklace=项链
gold=黄金
nose ring=鼻环
silver=银
earrings=耳镮,耳坠
wristwatch=手表
brooch=胸针
bracelet=手镯,手链
tie clip=领带夹
shoe=鞋子
leather shoes=皮鞋
shoe heel=鞋跟
high-heeled shoes=高跟鞋
brand=牌子
sports shoes=运动鞋
trying on shoes=试穿(鞋子)
flat shoes=平底鞋
size=尺寸
cloth shoes=布鞋
magnitude=大小
slippers=拖鞋
head circumference=头围
sandals=凉鞋
bust=胸围
boot=长靴
waistline=腰围
rain boots=雨鞋
hips=臀围
snakeskin=蛇皮
height=身长
crocodile leather=鳄鱼皮
leg length=腿长
dermis=真皮
great=大
artificial leather=人工皮
small=小
shoelace=鞋带
fit=合身
insole=鞋垫
tight=紧
socks=袜子
anklet=短袜
silk stocking=丝袜
short sock=踝短袜
in tube sock=中统袜
knee sock=及膝袜
panty hose=连裤袜
thigh stocking=过膝长袜
stockings=长统袜
fishnet thigh=网眼袜
cotton sock=棉袜
toe sock=脚趾袜
boat socks=船袜
