mother=母亲
passion=热情
smile=微笑
love=爱
eternity=永恒
fantastic=好极了,奇妙的
destiny=命运
freedom=自由
liberty=自主,独立自主
tranquillity=安宁,宁静
peace=和平
blossom=繁花盛开
sunshine=阳光
sweetheart=情人,爱人,亲爱的
gorgeous=绚丽的,华美的
cherish=珍爱,珍惜
enthusiasm=狂热,热情
hope=希望
grace=优美,优雅
rainbow=彩虹
blue=蓝色
sunflower=向日葵
twinkle=闪烁,闪耀
serendipity=意外新发现
bliss=福佑
lullaby=催眠曲,摇篮曲
sophisticated=精细的,精致的
renaissance=复兴
cute=可爱
cosy=舒适的
butterfly=蝴蝶
galaxy=银河
hilarious=欢闹的,狂欢的
moment=瞬间
extravaganza=娱乐表演,狂想曲
aqua=水
sentiment=感伤,柔懦情感
cosmopolitan=世界性,四海为家的人,世界主义者
bubble=气泡
pumpkin=南瓜
banana=香蕉
if=如果
lollipop=棒棒糖
bumblebee=大黄蜂
giggle=咯咯笑
paradox=似是而非,自相矛盾的论点
delicacy=精美
peek-a-boo=躲猫猫,藏猫猫
umbrella=雨伞
kangaroo=袋鼠
flabbergasted=目瞪口呆地
hippopotamus=河马
gothic=哥特风格的
coconut=椰子
smashing=极好的
whoops=哎哟！
tickle=发痒,胳肢
loquacious=爱说话的,喋喋不休
flip-flop=一种反复的声音,凉鞋,后空翻
smithereens=碎片
hi=喂,嗨
gazebo=凉亭,露台
hiccup=打嗝
hodgepodge=大杂烩
shipshape=整齐
explosion=爆发,迸发
fuselage=(飞机的)机身
zing=生命力,嗖嗖声
gum=口香糖
hen-night=女子婚前单身派对
