a bit (of)=少量(的);一点
a few=一些;几个
a kind of=一种,一类;某种;有一点
a little=少量;稍许
a number of=若干;一些
a pair of=一对…;一副…
a piece of=一片,一块
a place of interest=名胜;名胜古迹
a set of=一套;一组;一副
abandon=vt.丢弃;放弃,抛弃
ability=n.能力;才能;才智
able=能
aboard=prep./adv. 在飞机上;在船上;在火车上
Aborigines=n.(尤指澳大利亚的)土著居民
about=关于;大约
above=a.上述的 ad.在上面  prep.在..之上,高于
above all=首先;尤其是
abroad=adv. 在国外;到国外;出国
absence=n. 不在;缺席;缺乏
absent=a.不在场的;缺乏的
absolutely=ad.绝对地;完全地
absorb=vt.吸收
abstract=n. 摘要;抽象;抽象的概念
accent=n.口音;腔调;重音
accept=vt.接受;认可 vi.同意;承认
access=n. 接近;进入;接近的方法;到达的权力
accident=n.事故
according=(与to构成介词)按照,根据
according to=prep.按照;根据…所说
account=n.(事件的)报道,叙述
accurate=a.准确的,正确无误的
accuse=vt.指控,指责
accustomed=a.惯常的;习惯的
ache=vi.痛
achieve=v.实现,完成
achievement=n. 成就;功绩
acknowledge=vt.承认;致谢,鸣谢
acquire=vt.取得;获得;学到
across=横过;在对面
act=表演
action=动作片
active=积极的;活跃的
activity=活动
actor=n.演员
actress=n.女演员
actual=adj.现实的,实际的
AD=abbr.公元(后);耶稣纪元后
adapt=v.使适应
add=加
addition=n.加,加法;附加物
address=n.通讯处;地址
adjust=vt.调整;调节 vi.适应
administration=n.行政管理,管理机关
admirable=a.令人倾佩的,值的赞美的
admire=v. 赞赏;钦佩;羡慕
admission=n.准入;接纳
admit=vt.承认;准许…进入
adopt=vt.收养;采用;采取
adult=n.成年人
advance=vi./vt.前进;提前 n.前进;提升
advanced=adj.先进的;高级的
advantage=n.有利条件;优点
adventure=n.冒险;冒险经历
advertise=vt. 通知;为…做广告;使突出
advertisement=n.广告,公告;广告活动
advice=n. 劝告;忠告;建议
advise=v.劝告;建议
advocate=n.辩护者 vt.拥护;提倡
aeroplane=n.飞机
affair=n.事;事务;业务
affect=vt. 影响;感动;(疾病)侵袭
afford=v.负担得起;买得起
afraid=a.害怕的
Africa=非洲
African=adj.非洲的;非洲人的;非洲语的
after=prep.在…以后
after a while=过了一会,不久
after all=毕竟
after class=下课后;课下
after school=放学后
afternoon=下午;午后
afterward=ad.以后
afterwards=adv.后来;随后
again=又;再
again and again=再三地;反复地;一再地
against=prep.反对
age=n. 年龄;时代;寿命,使用年限;阶段
agency=n.机构;代理(处)
agent=n.代理人;代理商
aggressive=adj.侵略的,挑衅的
ago=ad. …以前
agree=同意;赞成
agree on=(在什么问题上)意见一致;商定
agreement=n.一致;协定
agricultural=a.农业的;农艺的
agriculture=n. 农学;农业
ahead=adj. 向前;在前的;adv. 向前的;领先的
aid=n.帮助;救助;援助;救护
aim=n.目标, 目的, 瞄准
air=vt.晾干, 使通风
aircraft=n.飞机,飞行器
airline=n. 航空公司
airport=机场
alarm=n.警报
album=n.集子;相片薄;唱片集
alcohol=n.酒精,乙醇
alike=a.相同的,相像的
alive=adj. 活着的;在世的
all=pron.全部;全体
all kinds of=各种;许多
all over=到处;遍及
all right=确实,无疑地
all sorts of=各种各样的
all the best=(口语)(祝你)一切顺利
all the same=(虽然)…还是,仍然,照样
all the time=始终,一直
all the year round=一年到头
allow=v.允许;承认
almost=ad.几乎;差不多
alone=adv.单独地;孤独地
along=prep.沿着
alongside=ad.在旁 prep.横靠
aloud=adv.出声地;高声地
already=adv.早已;先前
also=也;同样
although=conj.(though)虽然;即使;纵然
altogether=ad.完全;总而言之
always=总是
amaze=vt. 使吃惊 n.吃惊,好奇
amazing=adj.令人惊异的
ambition=n.雄心,抱负,野心
ambulance=n. 救护车(船､飞机);流动医院
America=美国
American=.a.美洲的    n.     美洲人
among=prep.在…之中;在一群(组)之中;于…之间
amount=n. 总额;总数;数量
amuse=vt.使发笑;使愉快
amusement=n.娱乐;消遣
analyse=vt.分析,分解 
analysis=n. 分析;分解
ancestor=n.祖宗;祖先
ancient=adj.古代的,古老的,古式的
and=和
and so on=等等 (表示列举未尽)
anger=n.怒;愤怒
angle=v.(用暗示等方法)取得,谋取 n.角,角度
angry=生气的;愤怒的
animal=动物
anniversary=n.周年纪念;周年纪念日
announce=v.宣布;通告
announcement=n.宣告;公告;告示
annoy=v.使恼怒;使生气
annual=adj.每年的,年度的
another=另一个
answer=n.问答;答复;答案
answering machine=录音电话
ant=蚂蚁
Antarctica=n.南极洲
anxiety=n.挂念;渴望;焦虑的事
anxious=adj.忧虑的;焦虑的;不安的
any=任何的;所有的
anybody=pron.任何人
anyhow=ad.无论如何; 至少
anyone=pron.任何人
anything=任何事;无论何事
anyway=ad.不管如何,不管怎么说
anywhere=adv.任何地方
apart=adv. 相隔;相距;除去;单独地
apart from=prep.除去…;撇去…
apartment=公寓;住宅
apologize=v.道歉,认错;辩护,辩解
appeal=vi./n.请求;呼吁;上诉
appear=vi. 出现;显得;似乎;出庭
appearance=n.出现,来到;外观
appetite=n.食欲,胃口;欲望
applaud=vi.拍手喝彩;称赞;赞同
apple=苹果
application=n.应用;实施;用途
apply=vt.应用;运用 vi.申请;请求
appoint=vt.任命,委任;约定
appointment=n.约定,约会
appreciate=v.感激,欣赏
appreciation=n.欣赏;感激
approach=vt.向…靠近;接近;处理n. 靠近;入门
appropriate=a.适宜的vt.私占;拨给
approve=vt.赞成,称许;批准
approximately=ad.近乎;接近
April=四月
architecture=n. 建筑学;建筑风格;建筑式样
area=n.地区;地域
argue=v.争论
argument=n.争论(吵),辩论;理由;论证
arm=手臂
armchair=沙发
army=n.陆军
around=adv.大约;到处;在附近;prep环绕
arrange=v.整理;布置;排列
arrest=vt.逮捕;拘留;扣留
arrival=n. 到达;抵达
arrive=到达;抵达
art=美术
article=文章
artificial=adj.人工的;人造的
artist=n.画家;艺术家
as=作为
as a matter of fact=事实上,其实
as a result=(插入语)作为结果,因此
as soon as=一…就
as usual=像往常一样,照例
as well=也,还;同样
as well as=也;还;而且
as...as=与…一样
ash=n. 灰;灰烬
ashamed=adj.惭愧的;害臊的
ashtray=n.烟灰缸
Asia=亚洲
Asian=adj.亚洲的;亚洲人的
ask=v.问,询问;请求
asleep=adj.睡着的
aspect=n.方面;样子,外表
assess=v.估计,估价;评估
assist=vt.帮助;援助
assistant=售货员
association=n.协会,社团
astonish=vt.使惊讶,使吃惊
astonishing=a.惊人的
astonishment=n.惊讶
at=在…(指时间的某一点)
at a time=每次;在某个时刻
at breakfast=早餐时
at first=首先
at home=在家
at last=最终;到底
at least=至少
at night=在晚上;在夜里
at once=立刻,马上
at one time=从前,曾经
at present=at this time;now 现在,目前
at school=在学校
at sea=在大海上
at the age of=在…岁时
at the beginning of=…起初;开始
at the bottom=在底部;在底端
at the latest=最迟,至迟
at the mercy of=任凭...摆布或控制
at the same time=同时
at work=在工作,在运转
athlete=n. 运动选手;运动员
athletic=adj. 体格健美的;体格强健的
atmosphere=n. 气氛;情绪;大气;大气层
atom=n.原子
attach=v.附; 使隶属; 使依恋
attack=v./n.攻击;袭击
attempt=n. 企图,试图;攻击
attend=v.出席,参加
attention=立正
attitude=n.态度;姿势
attract=vt.引起的注意(或兴趣等),吸引;引起;激
attraction=n.有吸引力的事物(或人)
attractive=a.吸引人的;有魅力的
audience=n.听众,观众,读者;见面,会见
August=adj.令人敬畏的, 威严的;n.八月(略作Aug)
aunt=n. 阿姨;姑妈;伯母;舅妈
Australia=澳大利亚
Australian=adj.澳大利亚的;澳大利亚人的
author=n.作者,作家,著作人;创始人,发起人
authority=n.权威机构;行政管理机构
automatic=a.自动的;无意识的
autumn=n.秋天
available=adj. 可利用的;可达到的;有效的
avenue=n.大街;林荫道
average=a.平均的;平常的,普通的
avoid=vt.避免;消除
awake=a.醒着的
award=n.奖;奖品
aware=a.意识到的;知道的
away=adv.向远处;离开;向另一方向
awful=极坏的;极讨厌的
awkward=a.尴尬的
baby=婴儿
back=n.背部, 后面
background=n.背景
backward=a.向后的
bacterium=n.(pl.bacteria)细菌
bad=adj. 坏的;严重的;劣质的
badly=ad.非常,严重地;坏地,差地,拙劣地
badminton=n.羽毛球
bag=n.袋;猎获物;手提皮包
baggage=n.行李
bake=v.烤;烘
balance=n.平衡;平衡状态;协调
ball=n.球, 球状物, 子弹, 舞会, 尽情地玩
balloon=气球
bamboo=n.竹;竹子 a.用竹子制的
ban=n.&vt.禁止;禁令
banana=香蕉
band=n.带子, 镶边, 波段, 队, 乐队
bank=n.银行, 堤, 储藏所(库)
bar=n.条;棒
barber=n.(给男子剪发或刮胡子的)理发师
bare=a.赤裸的
bargain=n. 廉价的东西;便宜货
base=n.底部, 基础, 根据地, 基地
baseball=棒球;棒球运动
basic=电脑初学者通用符号指令码
basin=n.盆;水盆
basis=n. 基础;底部;主要成分;基本原则或原理
basket=篮,篓,筐
basketball=篮球
bath=n. 沐浴;浴室;浴盆
bathe=v. 洗澡;沐浴;(使)浸没
bathroom=洗手间;浴室
battle=n.战争;战役
battlefield=n.战场
bay=n. 海湾;狗吠声adj.赤褐色的,栗色的
BC=(before Christ)公元前
be=是,在,做
be about to=正要,即将
be afraid of=害怕
be born=出生于…
be busy doing sth=忙着做某事
be covered with=被……盖满;充满着……
be familiar with=对…熟悉
be famous for=因…而有名的
be fond of=爱好
be full of=充满
be good at=擅长;在……方面做得好
be in love with=跟…恋爱
be made from=由……制成;由……构成
be made in=在…生产或制造
be made of=由…组成;由…构成
be made up of=由……组成
be proud of=以…自豪(高兴)
be related to=与…有关
be seated=坐下
be strict with=对……要求严格
be used to=习惯于
beach=n. 海滩;湖滨
beam=n.平衡木;笑容;眉开眼笑
bean=n.豆;一点儿
beancurd=n. 豆腐
bear=vt. 忍受;具有;支撑 n.熊
beard=n. 胡须;颌毛 vt. 公然反对;抓…的胡须
beat=v.打败;战胜;超过
beautiful=美丽的
beauty=n.美丽,美貌
because=因为
because of=因为;由于
become=成为
bed=床
bedclothes=n.铺盖(被､褥等)
bedroom=卧室
bee=n.聚会
beef=牛肉
beehive=n. 蜂窝;蜂箱
beer=n.啤酒
before=在……之前
before long=不久以后
beg=vt. 乞讨;恳求;回避正题
beg one's pardon=请原谅;对不起
begin=v.开始
beginning=开始
behave=v.举止;表现
behaviour=n.(behavior)行为;举止;习性
behind=在后面
being=n.物;生物;人
belief=n.信念;信心;信仰
believe=v.相信;认为
believe in=信任;信仰;支持;赞成
bell=n. 铃,钟;钟声,铃声;钟状物
belong=v.属于
belong to=属于;是…的成员
below=prep.在…下面,低于....
belt=n. 带;腰带;地带
bench=长凳
bend=vi. 弯曲,转弯;屈服;倾向;专心于
beneath=prep.在…下面
benefit=n.利益 vt.有利于,受益于
bent=n. 爱好,嗜好 adj. 弯曲的;决心的
beside=prep.在…旁;离开
besides=prep.而且;除……之外
best=adj. 最好的
best-seller=n.畅销书
better=n. 长辈;较好者;打赌的人(等于bettor)
between=在…之间
beyond=prep.在...那边,超出
bicycle=自行车
bid=v.说(问候的话等)
big=adj.大的
bill=n.帐单, 钞票, 票据, 清单, 议案, 法案, 广告
billion=n.十亿
biology=n.生物学
bird=n. 鸟;家伙;羽毛球
birth=n.出生;出世;诞生
birthday=生日
birthplace=n.出生地; 故乡
biscuit=n.(英)饼干;(美)软饼
bison=n. (单复同)北美野牛
bit=n.一点儿
bite=n. 咬;被咬(或叮)的伤痕;咬伤v.咬;叮
bitter=adj. 苦的;痛苦的;尖刻的;充满仇恨的
black=n.黑色, 黑颜料, 黑人
blackboard=黑板
blame=vt. 责备;归咎于 n. 责备;责任;过失
blank=n.空白
blanket=n. 毛毯;毡子;毛毯似的东西
bleed=vi. (bled,bled) 出血;流血
bless=祝福,保佑
blind=adj.盲的
block=vt.防碍, 阻塞
blood=n. 血, 血液, 血统
blouse=女(式)衬衫;罩衫
blow=v.风吹, 吹气于, 叫, 喘气
blue=adj. 蓝色的;忧郁的,沮丧的;下流的
board=n.木板, 甲板, 膳食费用, 会议桌
boat=n. 小船;轮船
body=身体
boil=v.煮沸;烹煮
bomb=n.炸弹
bone=n. 骨;骨骼;香烟;一首歌
book=n. 书籍;卷;帐簿;名册;工作簿
bookmark=n.书签
bookstore=书店
border=n.边界;边境
bored=adj.厌烦的;厌倦的
boring=无趣的;单调的;乏味的
born=v. 出世(bear的过去分词)
borrow=v. 借;借人;借来
boss=n.老板;上司vt.指挥
botany=n.植物学
both=pron. 二者;两者都
bother=vi.烦恼, 操心
bottle=n.瓶子
bottom=n.底部;尽头
bowl=n. 碗;木球;大酒杯
box=盒子
boy=n.男孩
boyfriend=n. 男朋友,情郎
brain=n.脑;头脑
brake=n.闸
branch=n.树枝
brand=n.商品;烙印;商标;牌子 vt.铭刻
brave=adj. 勇敢的;华丽的n. 勇士
bravery=n.勇敢, 勇气
bread=n. 面包;生计
break=vt.打破;vi.破(裂) (broke;broken)
break away from=摆脱;脱离
break down=分解;发生故障;失败;毁掉;制服
break into=闯入;破门而入
break off=折断;突然停止,暂停
break out=v. 爆发;突发
break the rule=违反规则
break up=打碎,破碎;结束;解散;衰落
breakfast=早餐
breath=n.呼吸;气息
breathe=v.呼吸
breathless=a.屏息的
brick=n.砖;砖形物
bride=n.新娘
bridge=桥
brief=a.简洁的;扼要的
bright=adj. 明亮的,鲜明的;聪明的;愉快的
bring=v.拿来,带来
bring down=减少,降低
bring in=引进;引来
bring on=引导,导致;使发展
bring up=教育;提出(供讨论)
Britain=英国
British=adj. 不列颠的;英国的
broad=a.宽的
broadcast=n.& v.广播
brochure=n.小册子
broom=n. 扫帚;金雀花
brother=兄弟
brotherhood=n.兄弟般的关系
brown=adj. 棕色的,褐色的;太阳晒黑的
brush=n.刷子, 毛刷, 画笔
bucket=n.铲斗;桶
budget=n.预算;预算案
build=建造
build up=增进
building=建筑物
burden=n.担子,负担 vt.劳累
burial=n.葬礼;埋葬
burn=vi. 燃烧;烧毁;发热 n. 灼伤,烧伤;烙印
burn down=(使)烧成平地;烧毁
burst=vi.破裂;爆炸vt.冲破
burst into laughter=突然笑起来
bury=vt. 埋葬, 掩埋, 隐藏
bus=汽车
bush=n.灌木,灌木丛,矮树
business=n.商业
businessman=n.商人
busy=a.忙碌的;繁忙的,繁华的
but=conj. 但是;而是;然而
butcher=n.屠夫;屠杀者
butter=n. 黄油;奶油;奉承话
butterfly=蝴蝶
button=n.按钮;钮扣
buy=vt. 购买;获得;贿赂
by=[表示交通工具等]乘, 坐
by accident=偶然,意外
by air=通过航空途径
by mistake=错误地
by sea=乘船
by the way=顺便;附带说说
bye=再见(口语)
cabbage=洋白菜;卷心菜
cafe=n. 咖啡馆;小餐馆
cafeteria=n.自助餐厅
cage=n.笼子;囚笼
cake=n. 蛋糕;块状物;利益总额
calculate=vt.计算;估计;计划
calendar=n. 日历;行事历
call=vi. 呼叫;拜访;叫牌
call back=叫回来,收回(错话等)
call for=要求;需要
call in=召集;打电话
call on=访问;号召;邀请
calm=adj. (心情)镇静的;无忧虑的
calorie=n.(calory)卡路里(热量单位)
camera=照相机
camp=n. 露营  vi. 露营;扎营
campaign=n.运动;竞选运动
can=n.罐头, 铁罐
Canada=加拿大
Canadian=n.加拿大人
canal=n.运河;(人体内)导管
cancel=vt.取消,撤消;删去
cancer=n.癌(症),毒瘤,肿瘤
candidate=n.候选人;参加考试者
candle=n.蜡烛
candy=糖果
cap=n.帽子
capital=n.省会;首都
capsule=n.胶囊(药)
captain=队长;首领
car=n. 汽车;车厢
card=n. 卡片;纸牌;明信片
cardigan=n.开襟绒线衫
care=v.对……在意;对……计较
care for=照料;照顾
careful=小心的;仔细的
careless=粗心的
carelessly=adv.粗心地
Carol=卡罗尔(女名)
carpet=n.地毯,毡毯,毛毯
carriage=n.马车, 客车, 运费, 姿态, (机械)车架
carrot=胡萝卜
carry=vt.携带, 运送, 支持, 支撑, 传送, 意味
carry off=拿走,夺去…的生命
carry on=继续开展,坚持下去
carry out=进行(到底),开展
cart=vt. 用车装载
cartoon=n.卡通,漫画
carve=vt./vi.雕刻
case=n.盒;袋;箱
cash=n. 现金;现款;现付(款)
cassette=n.卡式录音带盒;卡式胶卷盒
castle=n.城堡
castor=n.蓖麻
casual=adj.偶然的,随便的
cat=n.猫
catch=v.捕获, 赶上(车船等), 发觉, 感染(疾病)
catch fire=着火;开始燃烧
catch up with=赶上,追上;逮捕;处罚
cattle=n.牛;家养牲畜
cause=n.原因, 导致某事发生的人或事, 动机, 理由
cautious=adj.谨慎的,当心的
cave=n.洞穴;窑洞
ceiling=n.天花板;顶篷
celebrate=庆祝;祝贺
celebration=n.庆祝,庆祝会
cell=n. 细胞;电池;蜂房的巢室;单人小室
cent=n. 分;一分的硬币
centimetre=n. 厘米;公分
central=adj.中心的, 中央的, 重要的, 主要的,
centre=n.中心
century=n.世纪,百年;一百个
ceremony=n.仪式;典礼
certain=adj.确定的, 某一个, 无疑的, 必然的,
certainly=当然;可以
chain=n.链,链条;一连串
chair=椅子
chairman=n. 主席,会长;董事长
chalk=n.粉笔
challenge=n.挑战
chance=n.机会;机遇
change=(使)改变;变化
change one's mind=改变主意
channel=频道
chapter=n.章;回,篇
character=n.人物;角色
characteristic=n.特性;特点
charge=vt.使充电;要(价);控告;攻击
chart=图表
chat=n.&vi.聊天,闲谈
cheap=adj. 便宜的;小气的;不值钱的
cheaply=adv.廉价地;便宜地
cheat=n.欺骗, 骗子
check=v.核对;检查
check out=结账后离开;检验合格
cheek=n.面颊,脸蛋
cheer=v.使高兴,给…安慰(鼓励);欢呼,喝彩
cheese=奶酪
chemical=a.化学制品;化学药品
chemist=n.化学家;药剂师
chemistry=n.化学
cheque=n.支票
chess=n.国际象棋
chest=n. 胸腔;胸膛
chew=v.嚼;咀嚼
chicken=n. 鸡肉;小鸡;胆小鬼,懦夫
chief=n.首领;上司 a.主要的;最高级别的
child=n.孩子;儿女
childhood=n.孩童时期;童年时代
chime=n.(乐器等)谐和的乐声
chimney=n.烟囱,烟筒
China=中国
China Radio International=中国国际广播电台
Chinese=中文
chocolate=巧克力
choice=n.选择(权);供选择的东西a.上等的,精选的
choose=选择
chopsticks=n.(通常用复数)筷子
Christian=n.基督教教徒 a.基督教的;具有基督的
Christmas=圣诞节
church=n.教堂
cigar=n.雪茄烟,叶卷烟
cigarette=n.香烟;卷烟;纸烟
cinema=电影院
circle=圆形
citizen=n. 公民;市民;(城镇)居民
city=n. 城市,都市
civil=a.公民的;国内的;文明的
civilisation=n.文明;开化
clap=n.n. 鼓掌;拍手声 vt.拍手,鼓掌
clarify=vt.澄清,阐明
class=n.班级, 阶级, 社会等级
classic=a.经典的,典型的
classmate=同学
classroom=教室
clean=vi. 打扫,清扫
clear=a.天晴的,晴朗的;清澈的;清楚的
clear away=把…清除掉;(云)消失
clear up=消除(误会等);整理
clerk=n.(银行､办公室､商店等)办事员
clever=聪明的;机灵的
climate=n.气候
climb=攀登;爬
clinic=诊所
clock=n. 钟vt.测 …的速度
close=关;关上
cloth=n.布;织物;衣料
clothes=衣服
clothing=n.(总称)衣服;衣着
cloud=vi..乌云密布, 阴沉
cloudy=多云的
club=n.社团;俱乐部
coach=n. 教练;旅客车厢;长途公车;四轮大马车
coal=n. 煤
coast=n.海岸
coastline=n.海岸线
coat=n. 外套
cock=n.公鸡
cocoa=n.可可粉(茶,树,色)
coffee=咖啡
coin=n.钱币;硬币
coke=n.可乐, 焦炭
cold=adj. 寒冷的;冷淡的,不热情的
cold-blooded=a.(指人或行为)无情的,残酷的
collar=n.衣领;硬领;项圈; 护肩
colleague=n.同事,同僚
collect=v.收集;搜集
collection=n.收藏品;收集物
college=n.学院;大学
colour=n. 颜色, 气色, 风格, 外貌
comb=梳子
combine=v.结合;联合
come=vi.来,来到,出现
come about=发生
come across=偶然遇见;碰上
come down=下来,降落;流传下来;倒塌;落魄,失势
come from=来自
come in=进来
come off=(计划等)实现;举行
come on=(劝说等)来吧;开始
come out=出版;发表
come to=v. 想起;共计
come true=实现,成真;成为现实
come up=上升
comedy=喜剧
comfort=n.舒适;安慰
comfortable=a.舒适的,舒服的
command=n./vt.指挥;控制;统率
comment=n.评论;意见
commercial=(电视或无线电中的)广告
committee=委员会;委员会的委员
common=adj.共同的;共有的
communicate=v.通话;交际;交流思想
communication=交流;联络
communism=n.共产主义
communist=n.共产党人
community=社区
companion=n.同伴;同事
company=n.公司
compare=v.比较
compare with=对照
comparison=n. 比较;对照
compete=vi.比赛;竞争;对抗
competition=竞赛;比赛
competitor=n. 竞争者,对手
complete=adj.完整的;完全的
completely=adv.完全地
complex=a.错综复杂的;难解的
composition=n.作文作品
comprehension=n.理解,理解力;领悟
compressed=a.压缩的
computer=电脑
comrade=n.同志
conceited=a.骄傲自满的
concentrate=v.集中,骤集
concept=n.概念,观念,设想
concern=n.关切的事;感兴趣的事
concert=音乐会;演奏会
conclude=vt.&vi.推断出,断定
conclusion=n.结论
concrete=n.混凝土;具体事物adj.具体的;有形的
condition=n.条件;状况
conduct=vt.实施;管理;指挥;引导 n
conductor=n.(汽车､电车上的)售票员;列车员
conference=n.会议;讨论会
confident=a. 确信的,自信的
confirm=vt.证实,使...更坚定
conflict=n.斗争;战斗;冲突
confuse=v.混淆;辨不清;使困惑
congratulate=vt.祝贺,向…道喜
congratulation=n.(常用复数)祝贺;庆贺
conjecture=n. 推测;猜想
connect=v.连接;关联
connect with=连接;相通,衔接
connection=n.联系;关系;联结
consequence=n.结果
consider=v.考虑;思考;认为
considerate=a.考虑周到的;体谅的
consist=vt. 由…组成;由…构成
constant=adj.不变的;经常的
construct=vt. 建造;建设
construction=n. 建造;建设;建造方法;建造物
consult=vt.请教;咨询;查阅
consume=vt.消耗;消费
contain=vt.包含;容纳
container=n. 容器;集装箱
content=n. 内容;目录;容量 adj. 满
continent=n.大陆;陆地
continue=v.(使)继续;连续,持续
contrary=adj. 相反的;相对的;对抗的
contrast=n.对比,相比
contribute=vi.贡献
contribution=n.贡献
control=v.控制;支配;管理
convenience=n.便利,方便
convenient=adj.方便的;便利的
conversation=n.交谈;谈话
convey=vt.传送;运送;传播
convince=v.使确认;使信服
cook=vt. 烹调,煮
cookbook=n.食谱
cool=adj. 凉爽的;冷静的;出色的
cooperation=n. 合作;配合
copy=n.(书报等)一本(份､册…)
coral=n.珊瑚
corn=n.(美)玉米;谷类庄稼
corner=角落;街角;墙角
corporation=n.公司,企业;社团
correct=adj.对的;正确的,准确的
correction=n.改正,纠正,修改
cost=v.价值(若干);花(多少钱)
cottage=n.村舍;小别墅
cotton=n.棉花
cough=n.& v.咳嗽
count=v.数(数目),点计(数)
counter=n.柜台
country=国家
countryside=n. 乡下;农村;乡村
couple=n.夫妇
courage=n. 勇气;胆量
course=n.课程
court=n.球场;法院;庭院
courtyard=n.庭院,院子
cousin=堂(表)兄(弟);堂(表)姐(妹)
cover=n. 封面,封皮;盖子;掩蔽物vi. 覆盖;代替
cow=n.奶牛
co-worker=n.同事;合作者(新初九)
crash=n.碰撞, 坠落, 坠毁, 撞击声, 爆裂声
crazy=adj.疯狂的;狂热的
cream=n.奶油;乳脂
create=v.创造,创作;创建
creature=n.生物;动物
credit=n.信用
crew=n.全体船员
crime=n.犯罪;罪行
criminal=n.犯人,罪犯,刑事犯
crisp=adj.脆的;松脆的
crop=n.庄稼;收成;一批, 大量
cross=n.十字, 交叉, 十字架, 十字形物
crossing=十字路口
crossroads=n.十字路口,汇集地
crowd=v.挤满,塞满,充满
cruel=adj. 残忍的;残酷的
cry=vi. 哭;叫;喊
cubic=a.立方形的
culture=文化
cup=n.杯子
cupboard=n.碗柜;橱柜;衣柜
cure=n. 治愈; 药物; 疗法; 措施vt. 治愈
curious=adj.好奇的, 求知的, 古怪的, 爱挑剔的
curiously=ad.好奇地;稀奇古怪地
currency=n.通货,货币
curtain=窗帘
cushion=n.垫石;垫子;坐垫
custom=n.风俗,习俗;习惯
customer=n.顾客;主顾
cut=vt. 切割;削减;缩短;刺痛
cut off=切掉;切断;突然中止
cut through=刺穿;抄近路走过
cut up=vt. 切碎;抨击
cycle=n.周期;循环 vi.骑自行车
cyclist=n.骑脚踏车的人
dad=n.(口语)爸爸
daily=adj.每日的
dam=n.水坝,水堤;障碍物
damage=vt./n.损害;伤害
damp=a.潮湿的
dance=n. 舞蹈;舞会;舞曲
danger=n.危险
dangerous=危险的
dare=v.胆敢
dark=n.黄昏;黑暗
darkness=n.黑暗;漆黑
dash=vi.冲,猛冲;猛撞
data=n.(复数)资料,数据
database=n.数据库
date=n. 日期;约会;年代;枣椰子
daughter=女儿
dawn=n.开端;黎明
day=n.天
day after day=日复一日
day and night=日日夜夜地
daylight=n. 日光;白昼;黎明
dead=a.死的;无生命的;死气沉沉的 ad.完全地
deadline=n.截止时间;最终期限
deaf=adj.聋的
deal=n.交易, (政治上的)密约, 待遇, 份量
deal with=处理,料理
dear=adj. 亲爱的;尊敬的;昂贵的
death=n.死,死亡
debate=n. 辩论 vt.与…辩论 vi.辩论;参加辩论
debt=n.债务,欠款
decade=n.十年,十年期
December=十二月
decide=决定;下决心
decision=n.决定;决心
declare=vt.声明;宣布
decline=vt.下倾;偏斜;衰退
decorate=v.装饰;修饰
decrease=vi.变小;减少
deed=n.行为, 事实, 功绩, 实行, 契约
deep=adj. 深的;低沉的;深奥的
deer=n.鹿
defeat=vt.击败;战胜 n.失败;败北
defend=vt. 为……辩护(答辩);防卫
definite=adj.明确的,限定的
degree=n.学位;度数;度;程度
delay=vt.&vi.推迟;耽搁
delicious=美味的
delight=n. 欣喜;高兴;愉快
delighted=a.高兴的,欣喜的
deliver=v.投递
demand=vt.要求
dentist=牙医
department=n.部;局;部门
department store=百货商场
depend=v. 依赖;依靠
depend on=视……而定;决定于
depth=n.深;深度;厚度
describe=描述;形容
description=n.描述;记述
desert=n.沙漠
deserve=v.应得;值得…
design=n.设计;构思;谋划
designer=n.设计者
desire=n.愿望;心愿;要求 vt.期望;希望;请求
desk=课桌
desperate=a.拼死的;绝望的
destroy=v.破坏
detail=n.细节;详情 vt.详述;细说
detective=n.侦探
determination=n.决心
determine=vi.决定;决心
determined=a.坚决的
develop=v.发展;壮大;完善
development=n. 发展;生长
devote=vt.投入于;献身
devote to=献身于……;专心于……(高必1上)
devotion=n.献身;忠诚;专心
diagram=n.图表
dial=v.拨号码(打电话)
dialog=n.(dialogue)对话,对白
dialogue=n. 对话;(文学､戏剧､电影中的)对白
diamond=n.钻石
diary=日记
dictation=n.口授笔录,听写
dictionary=字典
die=v.死;死亡
die of=病(饿､冻)死
die out=灭绝;逐渐消失
diet=n. 饮食;节食
differ=vi.不同; 有差别
difference=n. 不同;差异;区别
different=adj.差异的;不同的
differently=adv.不同地;有区别地
difficult=adj.困难的
difficulty=n. 困难;难事
dig=v.挖
digest=vt.消化(食物);领会
digital=adj.数字的;数字显示的
dilemma=n.窘境,进退两难
dingo=n.澳洲野犬
dining room=餐厅
dinner=n.晚餐;正餐
dip=n.(在江河湖海中)洗澡;游泳 vt.浸;泡;蘸
diploma=n.文凭
direct=vt.&vi.导演
direction=方向
director=n.主管;主任
directory=n.姓名地址录
dirt=n. 泥土;污垢(如烂泥､灰尘等)
dirty=a.脏的,下流的
disability=n.伤残;无能;无力
disabled=adj.肢体有伤残的
disadvantage=n.不利条件;缺点
disagree=v. 不同意;持不同意见
disagreement=n.分歧;意见不合;不一致
disappear=v.消失
disappoint=vt. 使失望;使(计划等)受挫折
disappointed=a.失望的
disappointing=adj.使人失望的;令人扫兴的
disappointment=n.失望;沮丧
disaster=n.灾难;灾祸
discount=n.折扣
discover=v.发觉;发现
discovery=n.发现;被发现的事物
discrimination=n.歧视;区别
discuss=u.讨论;议论
discussion=n.讨论
disease=n.疾病
dish=n.一道菜肴
disk=n.(disc) 磁盘, 磁碟片, 圆板, 圆盘, 圆盘
dislike=v.不喜欢
dismiss=vt.驳回,对…不予受理
disobey=vt.不服从
distance=n.距离;路程
distant=a.遥远的
distinguish=v.使显出特色,使杰出,区别,辨别
distribute=vt.分发,分送;分布
district=n.地区
disturb=v.妨碍;打扰
dive=vi. 潜水;跳水;俯冲;急剧下降
diverse=a.不一样的,相异的
divide=v.分开
DNA=脱氧核糖核酸(基因的基本成分)
do=aux.v.vt.做,干,办
do one's best=尽力,努力
do one's homework=作必要的准备
do well in=在……方面做得好
do wrong=做错;作恶,犯罪
doctor=医生
document=n.公文;文件
dog=n. 狗;vt. 跟踪
doll=n.洋娃娃, 玩偶, 美丽但无头脑的女子
dollar=n.元(美国等国的货币单元,符号为
door=n. 门;家,户;门口;通道
dorm=n.宿舍
double=v.是……的两倍;使加倍
doubt=n./vt.怀疑;疑惑
down=ad.向下,往下
downhill=a.快速下降滑雪的;下坡的;倾斜的
download=v.下载
downstairs=往楼下;在楼下
downtown=n.(城镇的)商业区;中心区
downward=a.向下的 ad.向下地
dozen=n.一打,十二个
drag=vt.拖;拖曳
draw=画
drawer=n.抽屉
drawing=画画
dream=n.梦;梦想;幻想
dream of=梦想;梦到
dress=n. 连衣裙;女装
drier=n.吹风机
drill=vt.钻孔;在…上钻孔
drink=vt. 喝,饮;吸收;举杯庆贺
drive=开车;驾车
driver=司机
drop=n.落下, 下降, 滴, 滴剂
drown=vi. 溺死 vt.使淹死;淹没
drug=n. 药;毒品;麻醉药;滞销货
drum=n.喇叭
drunk=a.醉酒的;(喻)陶醉的 n.酗酒者,醉汉
dry=a.干的;干燥的
ducat=n.古时候在欧洲通用的金币
duck=n.鸭子, 急忙蹲下, 闪避
due=n. 应付款;应得之物adj. 到期的;预期的
duke=n. 公爵,(公国的)君主;公爵(种)樱桃
dull=adj. 不鲜明的, 不清楚的, 晦暗的
during=在……期间
dusk=n.黄昏,傍晚
dust=n. 灰尘;尘土;粉尘
dusty=a.满是灰尘的
duty=n.责任,义务
dynasty=n. 王朝,朝代
e.g.=例如(研究生32)
each=各自;每个
each other=相互,互相
eager=a.渴望的,热切的
ear=n. 耳朵;穗;听觉;倾听
early=ad.早
earn=v. 赚;挣得
earn one's living=谋生
earth=n.地面
earthquake=n.地震
ease=n.悠闲;舒适;自在;安心
east=n.东方, 东, 东部地区
eastern=adj.东方的;东部的
easy=容易的
eat=vt. 吃,喝;腐蚀;烦扰
eat up=吃完,吃光;耗尽
edge=n.边;边缘
edition=n.版,版本,版次
editor=n. 编辑
educate=v.教育;教导;培训
education=n.教育;培养
effect=n.结果;后果
effort=n.努力;勉力的尝试
egg=蛋
eight=num. 八;八个;第八
either=pron.任一, 随便任一个
either...or=不是…就是…;或者…或者…
elder=adj. (指家庭成员)年纪较长的
electric=adj.电的;导电的
electrical=adj. 电的;与电有关的
electricity=n.电;电学
electronic=a.电子的
elephant=大象
eleven=十一
else=其他的
embarrass=n.使窘迫;使尴尬
emergency=n.紧急情况;突发事件;非常时刻
emotion=n.感情;情感;触觉
employ=vt. 雇佣;利用
empty=a.空的
encourage=v.鼓励
encouragement=n.鼓励;促进
end=n. 结束;穷尽;到……的尽头
end up=结束
endeavour=n./v.努力,试图,尽力
endless=a.无止境的;无穷的
enemy=n.敌人
energetic=adj.有活力的;精力旺盛的
energy=n.活力;力量
engage=vt. 使订婚;约定;雇用;使从事
engine=n.发动机
engineer=工程师
England=英国
English=a.英国的n.  英语
Englishman=n.(pl.Englishmen)英国(男)人
enjoy=v.欣赏,喜爱,享受…的乐趣
enjoy oneself=过得快活;玩得高兴
enjoyable=a.愉快的;有趣的
enlarge=vt.扩大
enough=足够的
enter=vt.进入, 加入, 参加, 登录, 开始
enterprise=n.艰巨的事业;事业心;企业;单位
entertain=v. 款待;招待
entertainment=娱乐节目
enthusiastic=adj.热情的,热心的
entire=adj.完全的,全部的
entrance=n.入口;进入;入场
entry=n.进入;词条
envelope=n.信封
environment=n.环境
envy=vt,n.妒忌;羡慕
equal=a.相等的;胜任的 vt.等于;比得上
equality=n. 向等;平等
equally=adv.平等地;公平地
equip=vt.装备,配备
equipment=n.设备,器材,装置
eraser=橡皮
error=n.错误;差错
escape=v.逃跑;逃走
especially=adv.特别;尤其
Europe=n.欧洲
European=adj.欧洲的;欧洲人的
evaluate=v.估计,估算,求值
even=adj.平的, 平滑的, 偶数的, 一致的
evening=夜晚;晚上
event=n.(体育运动的)比赛项
eventually=ad.终于;最后
ever=adv. 曾经, 永远, 不断地
ever since=从那时起一直到现在
every=ad.每一,每个
everybody=每个人,人人
everyday=adj.每日的,日常的
everyone=每个人
everything=pron.每件事物
everywhere=adv.各地;到处
evidence=n.根据;证据,证人
evident=adj.明显的,明白的
exact=adj. 正确的;精确的;严谨的
exactly=ad.确切地,准确地
exam=考试;检查
examination=n.考试,测验
examine=v.检查
example=n.例如,例子
excellent=adj.卓越的;极好的
except=prep.除;把……除外
exchange=v.换;更换;调换
excite=vt.激动; 引起, 招惹
excited=adj.激动的;兴奋的
exciting=激动人心的
excuse=原谅,作为……的托辞
exercise=锻炼
exhibition=n.展览;展览会
exist=vi.存在;生存
existence=n.存在,实在;生存
exit=n.出口
expand=vt.张开; 膨胀; 扩大
expect=v.预计;预料
expedition=n.远征;探险队
expense=n.花费,消费;费用
expensive=昂贵的
experience=n.经历,经验
experiment=v.试验,实验
expert=n.专家;高手
explain=v.解释;说明
explanation=n. 解释;说明;阐述
explode=vt.&vi.(使)爆炸
exploit=vt.开采;开发
explore=v.探险;考察
explorer=n.探险者;考察者
export=n.输出;出口(商品) vt.输出
expose=vt.揭露;暴露
express=vt.表示;表达
expression=n.表达,表示,措辞,
extra=adj.额外的
extraordinary=adj. 特别的;不平常的;惊人的
extreme=a.极端的;极度的;偏激的
extremely=adv.极其,非常
eye=眼睛
face=n. 脸;表面;面子;面容
face to face=面对面(的)地;对立地
fact=n. 事实;实际;真相
factory=n.工厂
fade=vi.枯萎; 褪色; 衰弱
fail=vi. 失败,不及格;破产;缺乏;衰退
failure=n.失败,失败的人(事)
fair=adj. (头发)金黄的, 干净的, 公平的
fairly=adv.相当,完全
fairness=n. 公平;公正
faith=n.信任,信念;忠实
fall=n.秋天, 落下, 瀑布, 降低, 落差
fall asleep=入睡
fall ill=得病
fall in love with=爱上
fall off=下降,跌落,减少
false=adj. 错误的;假的;伪造的
familiar=adj.熟悉的,亲近的
family=家庭
famous=a.著名的
fan=n. 迷;风扇;爱好者
fancy=a.别致的;花哨的
fantastic=极好的,极妙的
far=a.& ad.遥远
far away=远的,遥远的
far from=远离,决不,完全不
fare=n.费用, 旅客, 食物
farm=vi. 种田,务农;经营农场 n. 农场;农家
farmer=农民
farming=n.农业,务农
farmland=n.农田
farther=a.&ad.(far的比较级)更远;较远
fashion=n. 时尚;时装;样式;时髦人物
fast=adj. 快速的,迅速的;紧的,稳固的
fasten=vi.扣紧, 抓住
fat=adj. 肥的,胖的;油腻的;丰满的
father=n. 父亲,爸爸;神父;祖先;前辈
fault=n.过错, 缺点, 故障, 毛病
favour=n.赞赏;偏袒;恩惠 vt.偏爱,赞同
favourite=喜爱的
fax=n.传真系统;传真件
fear=v.害怕;担心
feather=n.羽毛
feature=n.特点;特征
February=二月
fee=n.费,费用
feed=n.饲养, 饲料, (动物或婴儿的)一餐
feel=vt. 感觉;认为;触摸;试探
feeling=n.感情;感觉;想法,看法;感受心情
fellow=n.人, 家伙, 伙伴, 学会特别会员, 朋友,
female=a.女性的,雌性的 n.女子,妇女,雌性动
fence=vi.击剑, 围以栅栏, 跳过栅栏, 搪塞
festival=节日
fetch=v.取来,接来,
fever=n.发烧
few=adj.(表示否定的)很少的;几乎没有的
fibre=n.纤维,纤维制品
fiction=n.虚构, 编造, 小说
field=n.田野,牧场,场地
fierce=adj. 激烈的;凶猛的;强烈的
fifteen=十五
fifth=第五
fifty=五十
fight=打架
figure=n.(统计)数字
file=n.文件夹
fill=vt. 装满,使充满;满足;堵塞vi. 被充满,膨胀
fill in=填写,填充
film=n.电影,影片
final=adj.最后的;最终的
finally=最后
finance=n.财政; 金融 vt.资助
find=v.找到;发现
find out=查明;发现
fine=adj. 好的;优良的;细小的,精美的
finger=n. 手指;指针,指状物
finish=v.结束;完毕;完成
fire=n.火;火灾,失火;炉火 vi.开火 vt.放(枪)
firm=n.公司
firmly=adv.牢牢地
first=第一
first aid=急救
first of all=首先
fish=n. 鱼,鱼类
fist=n.拳头
fit=vi.适合
fitting=n.装置;设备
five=num. 五,五个
fix=n.困境, 方位, 贿赂
fix up=修理;修补
fixture=n.固定装置
flag=n.旗子
flame=n.火焰;热情,激情;〈俚〉爱人,情人;激动
flaming=adj. 燃烧的;火红的;激昂的
flash=n. 闪光, 闪现, 一瞬间
flat=adj.平坦的, 扁平的, 单调的,  无聊的
flesh=n.肉;(供食用的)肉;果肉
flexible=adj. 灵活的;柔韧的;易弯曲的
flight=n.飞行, 逃走, 飞跃, 飞机的航程, 班机
float=n.漂流物, 浮舟, 漂浮, 浮萍, 彩车
flood=vt.淹没, 使泛滥, 注满, 充满
floor=楼层
flour=n.面粉,粉;粉状物质
flow=n.流动
flower=n. 花;精华;开花植物
flu=流感
fluent=a.流利的;流畅的
fly=vt. 使飞, 放飞;n.苍蝇, 两翼昆虫, 飞行
focus=n.(兴趣活动等的)中心;焦点
fog=n. 雾;烟雾,尘雾;迷惑
foggy=a.有雾的,多雾的
fold=n.折, 羊栏, 折痕, 信徒
folk=n.人们,世人,(用作定语)民间的,部落的
follow=v.跟随
fond=a.(of)喜爱的,爱好的;宠爱的,溺爱的
food=n. 食物;养料
fool=n.愚人, 白痴, 莽汉, 受骗者
foolish=a.傻的,愚蠢的
foot=n. 脚;英尺;步调;末尾 vi. 步行;跳舞;总计
football=足球
for=为;给
for a while=暂时;一会儿;一段时间
for ever=永远
for example=例如
forbid=v. 禁止,不许
force=n.(常pl.)军队
forecast=n. & vt. 预测;预报
foreign=a.国外的,外国的
foreigner=n.外国人
foresee=vt.预见,预知
forest=森林
forever=ad.(for ever)永远;总是
forget=忘记
forgive=vt.原谅;饶恕
fork=n.树叉; 分岔; 岔路; 分岔点,叉子
form=n.形状, 形态, 外形, 表格, 形式
former=a.前任的
forth=ad.向前,向外
fortnight=n.十四天;两星期
fortunate=a.幸运的;侥幸的
fortunately=adv.幸运地
fortune=n.运气;机会;大笔的钱
forty=四十
forward=向前
found=v.建立, 创立, 创办, 使有根据, 铸造, 熔制
fountain=n.喷泉
four=num. 四;四个
fox=狐狸
fragile=a.易碎的
franc=n.法郎(法国､比利时和瑞士的货币单位)
France=法国
free=adj.自由的, 大方的, 免费的
freedom=n.自由
freely=adv.自由地
freeway=n.高速公路
freeze=v.(froze, frozen) 结冰;凝固
freezing=adj.极冷的,冻结的 n.冰点
French=法国人
Frenchman=n.法国人
frequent=a.时常发生的;经常的
frequently=adv.经常地;频繁地
fresh=新鲜的
Friday=星期五
fridge=冰箱
friend=朋友
friendly=友善的
friendship=n.友好;友谊
frighten=v.惊恐;吓唬
frog=青蛙
from=从…来
from now on=今后,从现在起
from then on=从那时起
from time to time=时常,有时,不时
from...to...=从…到…
front=n.& a.前面(的);前部(的)
fruit=n. 水果;产物
fry=n.油炸食物, 油炸锅, 鱼苗, 鱼秧
fuel=n. 燃料;刺激因素
full=a.充满的,详尽的 ad.完全地,十分 n.全部
fully=ad.完全地;充分地
fun=n. 乐趣;玩笑;adj. 供娱乐用的
function=vi.起作用;运转 n.功能;作用
funny=adj. 有趣的;滑稽的;奇异的
fur=n.毛皮;毛;软毛
furniture=n.家具(总称)
further=a.更远的;较远的
future=n.将来;未来
gain=v.获得;增加;表等走快 n.增进,增加;收益
gallery=美术馆
game=adj.勇敢的, 有胆量的, 关于野味的, 跛的
gap=n.缺口;空白处
garage=车库
garden=n. 花园;菜园
gardening=n.园艺;造园术;园林工作
garlic=n.大蒜
gas=n.气体
gate=n.大门
gather=v.集合,聚集;采集,收集;逐渐增加;推测
gay=abj.欢快的, 艳丽的, 快乐的, 放荡的
general=adj.一般的,概括的,全面的
generally=ad.一般地
generally speaking=一般来说
generation=n.一代(人)
generous=a.慷慨的;大方的
gentle=a.和善的
gentleman=n.绅士;有身份,有教养的人
gently=ad.轻轻地;逐渐地
geography=地理学
German=n.德语;德国人 a.德语,德国(人)的
Germany=n.德国
gesture=n.手势;姿态
get=vt.到达
get away=逃脱;离开;出发
get back=回来
get close to=接近
get down=从…下来;下车;写下
get down to=开始认真考虑或对待
get in=收获;收(税等);抵达
get married=结婚
get off=下车;离开;开始
get on=相处;进展
get rid of=摆脱,除去
get through=通过;度过;到达
get together=聚集,相聚一处
get up=起床
gift=n.赠品, 礼物, 天赋, 才能
gifted=a.有天赋的;有天资的
girl=女孩
girlfriend=n.女朋友
give=n.弹性, 可弯性
give advice=劝告,忠告
give back=归还;恢复;后退
give birth to=引起,发生
give in=让步;投降
give off=释放;放出
give out=分发;发放
give up=放弃
glad=高兴的,乐意的
glance=vi.匆匆一看;一瞥
glass=vt.装玻璃于, 反映
glasshouse=n.温室;暖房
globe=n.球状物;球体
glory=n. 光荣;荣誉;荣耀的事;壮丽
glove=手套
go=走
go against=违反;反对;不利于
go ahead=(对做某事的)许可
go back=回去
go bad=变坏;变酸;腐败
go by=(指时间)过去;消逝
go for a walk=去散步
go home=回家
go off=闹钟(闹响)
go on=继续下去;继续某种行为
go out=走出(房间等);罢工
go over=复习
go through=通过;经受;仔细检查
go to bed=上床睡觉
go to school=去上学
go to sleep=入睡
go to the cinema=去看电影
go up=上升;增长;攀登
goal=n.目的, 目标, 守门员, 球门
goat=n. 山羊;替罪羊(美俚);色鬼(美俚)
god=n.神
gold=n.金;黄金adj. 金的,金制的;金色的
golden=金色的
goldfish=金鱼
golf=v.& n. (打)高尔夫球
good=adj. 好的;优良的;愉快的;虔诚的
goodbye=int.再见
goods=n. 商品;货物
goose=n. 鹅;鹅肉;傻瓜;雌鹅
govern=vt.统治,治理;支配
government=n.政府
grade=n.等级, 级别
gradual=adj.逐渐的,逐步的
gradually=adj.逐渐地;渐渐地
graduate=n.毕业生
graduation=n.毕业(典礼);刻度
grain=n. 谷类;谷物
gram=n. 绿豆; 鹰嘴豆; 绿豆种子; 克
grammar=n.语法;语法规则
grand=a.豪华的;庄重的;雄伟的
grandchild=n.孙子,孙女;外孙,外孙女
granddaughter=n.孙女,外孙女
grandfather=祖父
grandma=奶奶(口语)
grandmother=祖母
grandpa=爷爷(口语)
grandparents=祖父母
grandson=n.孙子;外孙
grape=葡萄
graph=n.(曲线)图,图表
grasp=vt.抓牢;抓住;理解
grass=n. 草;草地,草坪
grateful=a.感激的;表示感谢的
gray=adj. 灰色的;苍白的;灰白头发的;阴郁的
great=n.全部, 大人物, 大师
greatly=ad.很;非常
greedy=a.贪婪的
Greek=n. 希腊语;希腊人adj. 希腊的;希腊人的
green=adj. 绿色的;青春的
greet=v.问候;招呼
greeting=n.招呼;问候
grey=adj. 灰色的;灰白的
grocery=n.食品;杂货店
ground=n.地面,地,场, 广场, 战场
group=团体;组
grow=v.生长;发育
grow up=成长;长大
guarantee=vt.保证;确保
guard=n. 守卫;警戒;看守;哨兵
guess=猜测
guest=n.客人;宾客
guidance=n.指引;引导
guide=向导,导游
guitar=吉他
gun=n.炮;枪
gym=体育馆､健身房
gymnast=n.体操运动员
gymnastics=n.体操
habit=n. 习惯;习性
hair=n. 头发;毛发;些微
haircut=n.理发;发型
half=n. 一半;半场;半学年
hall=n.厅,堂;会馆
ham=n.火腿;vi. 表演过火
hamburger=汉堡包
hammer=n.锤子;槌
hand=n. 手,手艺;帮助;指针;插手
hand down=把…传下来;传给
hand in=交上;递上
hand in hand=手拉手地,同时发生地
hand out=分发;发放
handbag=n.女用手提包
handful=n.一把;少数
handkerchief=手帕
handle=vt.操作;处理 n.柄;把手
handshake=n.握手
handsome=a.英俊的;大方的;美观的
handstand=n. 手倒立
handtruck=n. 手推运货车,手推车
handwriting=n.笔迹,手迹,书法
hang=v.悬挂
happen=v.发生
happiness=n. 幸福
happy=快乐的
harbour=n.(harbor)海港
hard=adj.硬的, 坚固的, (问题, 工作等)困难的,
hardly=adv. 几乎不;几乎没有
hardworking=刻苦的
hard-working=adj.勤勉的;努力工作的
harm=n.损害 vt. 伤害;危害;损害
harmful=a.有害的;伤害的
harvest=n.收获
hat=n.帽子
hate=v. 憎恨;憎恶
have=vt. 有;让;拿;从事;允许
have a cold=患了感冒
have a gift for=对……有天赋
have a good time=玩得高兴;过得快乐
have a headache=头疼
have a look=看一看;看一眼
have a seat=坐下,就坐
have an effect on=对…产生作用;对...有效果
have got to=(have to)不得不;必须
have sports=进行体育活动
have supper=吃晚餐
have to=不得不
he=他
head=n. 头;头痛;上端
headache=头痛
headline=n.(报刊的)大字标题
headmaster=n.(英)中小学校长
health=n.健康;身体状况
healthy=adj.健康的, 健壮的, 有益于健康的
hear=vt. 听到,听;听说;审理
hear about=听说
hear from=接到…的信
hear of=听说
hearing=n.听力
heart=n.心
heart and soul=全心全意地,完全地
heat=n.热,热度,高温;(身体的)发烧,发热
heaven=n.天堂;上帝
heavy=重的;沉重的
height=n. 高地;高度;身高;顶点
helicopter=n.直升(飞)机
hello=喂
help=帮助
help sb. with sth.=帮某人干某事
helpful=乐于助人的
her=她的
here=adv. 在这里;此时
here and there=零星分散,在各处
hero=n.英雄
hers=她的
herself=pron.(她)自己;她本人
hesitate=v.犹豫
hi=喂
hibernate=vi.冬眠
hibernation=n.冬眠
hide=n.兽皮, 皮革
high=a.高蝗;高度的
highway=n.公路;大路
hill=n. 小山;丘陵;斜坡;山冈
hillside=n.(小山)山腰;山坡
hilly=a.多小山的;陡的
him=pron.他(宾格)
himself=pron.他自己,他亲自(反身代词)
hire=vt.租借 n.租用,雇用
his=他的
history=n.历史
hit=n.打,击
hive=n.蜂巢; 蜂群; 闹市
hobby=n. 嗜好;业余爱好
hold=vt. 持有;拥有;保存;拘留;约束或控制
hold on=握住不放;坚持下去
hold one's breath=(由于激动等原因)屏息
hold out=伸出;坚持;支持
hold up=举起;拿起;举出
hole=n. 洞;孔;坑
holiday=假期
home=n. 家,住宅;产地;家乡;避难所
homeland=n.祖国;故乡
hometown=n.家乡;故乡
homework=n.家庭/课外作业
honest=诚实的
honey=n.(蜂)蜜, 蜂蜜;爱人; 恋人; 宝贝;
honeycomb=n.蜜蜂窝; 蜂窝状物
honour=vt.(honor)尊敬;给予荣誉
hope=n. 希望;期望;信心
hopefully=adv.有希望地
hopeless=a.没有希望的,绝望的
horizon=n.地平线;眼界,见识
horse=n. 马;骑兵;脚架;海洛因
hospital=医院
host=n. [计] 主机;主人;主持人;许多
hot=adj.热的
hot dog=热狗(小学三年级上)
hotel=旅馆
hour=n. 小时;钟头;课时;…点钟
house=n. 住宅;家庭;机构;议会
housewife=n.家庭主妇
housework=n.家务;家务事
housing=n.住房,住房供给;(外､阀)壳,防护罩
how=adv.如何;怎样
how far=多远
how long=多久
how many=多少
how much=(价钱)多少
how old=多大年纪;几岁
however=conj.然而
howl=n.嚎叫;怒吼;嚎哭
hug=vt. 拥抱;紧抱;抱有,坚持
huge=adj. 巨大的;庞大的;无限的
human=n.人;人类
human being=n.人类
humorous=a.富于幽默的,诙谐的
humour=n.幽默,诙谐
hundred=百
hunger=n.饿;饥饿
hungry=饥饿的
hunt=n.打猎;猎取;搜寻
hurricane=n. 飓风
hurry=n.匆忙, 仓促
hurry up=(使)赶快;迅速完成
hurt=n.伤痛, 伤害 v.受伤
husband=n.丈夫
I=我
ice=冰
ice-cream=n.冰淇淋
idea=n.想法,思想,意见
identity=n.身份
idiom=n. 习语;成语;语言习惯用法
if=(表条件)如果
ignore=vt. 不顾;不理;忽视
ill=有病的
illegal=a.against the law 不合法的,非法的
illness=n. 疾病;生病
imagination=n.想象力;想象
imagine=v.想象,设想
immediate=a.直接的,立即的
immediately=ad.立即地
imply=vt.暗示,意味
import=v.&n.输入,进口
importance=n.重要性,重大,价值
important=adj. 重要的;重大的;严重的
impossible=adj.不可能的;不会发生的
impress=v.使感动;给……深刻印象
impression=n.印象;感想
impressive=adj.给人深刻印象的;令人钦佩的
improve=改进;该善
in=在…里面
in a hurry=匆忙;立即,很快地
in a minute=立刻;马上
in a word=总而言之,总之
in all=总共;总之
in charge of=主管,掌管,照管
in common=共同(的);共有(的)
in danger=在危险中,垂危
in debt=欠债
in English=用英语(表达)
in fact=实际上;其实;确切地说
in front of=在……前面
in honour of=为向…表示敬意;为庆祝…;为纪念…
in need of=需要
in one's opinion=按照…的意法
in order=按顺序;整齐
in order that=以便,为了…
in order to=为了
in other words=换句话说,也就是说
in peace=和平的;和睦地;安详地
in place=在适当的位置
in public=公开地;公然
in surprise=惊奇地
in the air=在空中;未定
in the end=最后,终于
in the middle of=在中间;在中央
in the past=在过去
in this way=这样
in time=及时,总有一天,最后
in trouble=处于困境中;有麻烦
inch=n. 英寸;少量
incident=n.事件;;政治性事件,插曲;事变
include=v.包括;包含
income=n.收入;收益;进款
increase=v.增加,增大
indeed=ad.确实;实在
independence=n.独立;自主
independent=a.独立自主的
India=印度
Indian=adj.印度的;印度人的
indicate=v.标示;指示
indirect=a.间接的
individual=adj.个别的;单个的
industrial=a.工业的
industry=n. 工业,产业,勤勉,刻苦
infer=v.推定,推断
influence=n.影响
inform=vt. 通知;告诉
informal=a.非正式的, 非正规的
information=n.消息;资料
injure=vt. 损害;伤害;使蒙受损失
injured=adj.受伤的;受损害的
injury=n.伤害;受伤处
ink=n.墨水
innocent=a.清白的,幼稚的;无辜的;无罪的
insect=n.昆虫
insert=vt.插入
inside=在里面
insist=vi.(on)坚持
insist on=坚持(做) (insist upon)
inspect=vt.检查,审查;检阅
inspire=vt.鼓舞;感动;激发;启示
instant=a.立即的 n.紧迫;瞬间
instead=adv.代替;而不是
instead of=代替,而不是
institute=n.学会;协会;研究机构
institution=n.公共机构;学校
instruct=vt.指示,命令,教育
instruction=n. 指示;命令
instrument=n. 器具;工具;乐器
insurance=n.保险(业),保障
intelligence=n.智力;智慧
intelligent=adj. 理解力强的;有才智的
intend=vt.想要;打算;意指
interest=n. 兴趣;爱好
interesting=有趣的
international=国际的
internet=n. 网络;互联网
interrupt=vt./vi.打断;中断;插嘴
interview=n.面试;面谈
into=prep. 到…里;深入…之中
introduce=v.介绍
introduction=n. 序言;介绍;引进
invent=vt.创造,发明
invitation=邀请卡
invite=v. 邀请;恳请
iron=n.铁
irrigate=vt.灌溉
irrigation=n.灌溉;冲洗
island=n.岛;岛屿
islander=n.岛上居民
it=它
item=n.条;项
its=pron.它的
itself=pron.(it的反身代词)它自己,它本身
jacket=n. 夹克;短上衣
jam=n. 果酱;拥挤vi. 堵塞;轧住
January=一月
Japan=日本
Japanese=日本人
jar=n. 罐;广口瓶;震动;刺耳声
jazz=n.爵士乐;爵士乐曲
jeans=牛仔裤
jewel=n.宝石 vt.镶以宝石
jewellery=n.珠宝;首饰;珠宝类
job=n.工作;零工;任务;职位
join=v.参加,加入
join in=参加(活动)
join up=参军,入伍;联合起来
joke=n. 玩笑,笑话;笑柄
jokingly=ad.开玩笑地,打趣地
journal=n.杂志;日报
journalist=n. 新闻记者;报纸杂志撰稿人
journey=n.旅行;旅程
joy=n. 欢乐,快乐;乐趣;高兴
judge=n.法官, 审判员, 裁判员, 鉴赏家
judgement=n.判决;判断
juice=果汁
July=七月
jump=n. 跳跃;暴涨;惊跳
June=六月
jungle=n.热带丛林;密林
junior=adj.年少的,低级的
just=adj.正义的, 公正的, 正确的
just a minute=等一下;请稍等;就来了
just now=现在,眼下;刚才
just then=正在那时(新人初二下)
justice=n.公正;正义
kangaroo=袋鼠
keep=vt.保持, 保存, 遵守, 经营, 看守
keep back=留在后面;阻止;隐瞒
keep fit=保持健康
keep in touch with=...   与……保持联系
keep off=避开;不让…接近
keep one's balance=保持(身体)平衡
keep up=坚持;不使(斗志)低落
keeper=n.(动物园中的)饲养员
key=钥匙
keyboard=n.键盘
kg=千克;一公斤(小学六年级下)
kick=vt. 踢;反冲,朝后座
kid=v.戏弄,n小孩
kill=v.杀死;致死
kilo=n.千克;公斤
kilogramme=n.千克,公斤
kilometre=n.千米,公里
kind=n.种类, 性质
kindergarten=n.幼儿园 a.幼儿园的;启蒙阶段的
kindness=n.仁慈;和气;好意
king=n.国王, 君主, (部落的)首领, 纸牌中的K
kingdom=n.王国
kiss=n.吻;亲吻
kitchen=厨房
kite=n. 风筝
knee=膝盖
knife=刀
knock=v.敲,打;碰,撞击
knock at=敲(门,窗等)(新人初二下)
know=v.知道, 了解, 认识, 熟悉, 认出, 分辨, 确信
knowledge=n.知识;学识;学问;知晓;了解
koala=(澳洲)树袋熊
lab=n.实验室
labour=n.努力;(体力)劳动
lack=n. 缺乏(的东西) v. 缺乏;短少;没有
ladder=n.梯子
lady=女士;小姐;夫人
lake=n. 湖;深红色颜料;胭脂红
lamb=小羊;羔羊
lamp=n.灯vt.照亮 vi. 发亮
land=n. 国土;陆地;地面
landowner=n.地主;土地所有者
language=n.语言
large=adj. 大的;多数的;广博的
last=n. 末尾,最后;上个;鞋楦(做鞋的模型)
late=adv. 晚;迟;最近  adj. 晚的;迟的;已故的
lately=adv.最近;不久前
later=a. 更迟的,后面的; ad. 稍后,后来
latest=adj.最近的;最新的
latter=adj.后面的,后者的
laugh=笑
laugh at=笑话;取笑(某人)
laughter=n.笑;笑声
law=n.法律
lawyer=n.律师
lay=v.下蛋;产卵
lazy=adj. 懒惰的;懒洋洋的;怠惰的;慢吞吞的
lead=adj. 带头的;最重要的 n.子弹, 枪弹
lead to=导致某种结果
leader=n. 领导者,指挥者
leading=adj.最主要的;领导的
leaf=n. 叶子;(书籍等的)一张;扇页
league=n.里格(长度单位);联盟;社团
leak=n. 泄漏;漏洞,裂缝
learn=vi.学习, 听到, 获悉
learned=a.有才华的;博学的
learner=n.学习者
least=adj.最小的, 最少的
leather=n.皮革
leave=vt. 离开;留下;遗忘;委托
lecture=n.演讲;讲课
left=n.左,左边;ad.向左;a.左边的
leftover=n.剩余物;残留物;剩饭 adj.剩余的
leg=腿
legal=a.法律的,法定的
lend=v.借(出),借给
length=n.长度; 期间; 距离
less=adj.(little的比较级)较小的;更小的;较少
less than=不到,少于(新人初二上)
lesson=n.课
let=vi.出租, (工程等)被承包
let in=让…进入;放…出来
letter=n.文字, 字母, 信函, 字面意义, 铅字
level=n.水平,水准,等级 v.弄平,铺平 a.水平的
liberate=vt.解放;使获自由
liberation=n.解放
librarian=n.图书管理员
library=图书馆
lie=vi.平卧;躺
life=n.生活
lifetime=n.一生;终生
lift=v.举起,抬起,提升
light=n.光, 日光, 发光体, 灯
lightly=adv.轻轻地,轻微地
lightning=n.闪电
like=vt.喜欢, 希望, 愿意
likely=a.可能的;预期的
limit=vt.限制;限定 n.界限;限度
limited=adj.有限的
line=n. 路线,航线;排;绳vi. 排队
link=vt.连接;联系 n.环;关系;联系
lion=狮子
lip=n. 嘴唇;边缘
liquid=n.液体;液态物
list=n.清单
listen=听
listen to=听;倾听
literature=n.文学(作品);文艺
litre=n.升;公升
little=小的
live=adj.活的, 生动的, 精力充沛的vt. 经历
live on=靠…生活
lively=adj.活泼的;活跃的
living=a.活(着)的,生活(动)的;现行的n.生计
living-room=n. 起居室(研究生32)
load=n.负载,负担 v.装载
loaf=n.一条面包
local=adj.当地的,地方的
lock=vt. 锁,锁上;隐藏
logical=a.逻辑的;符合逻辑的
lonely=a.孤独的;寂寞的
long=adj. 长的;过长的;做多头的vi. 渴望;热望
long before=在…以前很久
long-term=a.长期的
look=vt. 看;期待;注意;面向;看上去像
look after=照看,照顾
look at=看;朝……看
look for=寻找;寻求
look forward to=盼望,期待;预期
look into=调查,观察
look out=留神;朝外看;照料
look round=掉头看;观光;察看
look up=(从词典中)查阅(词或资料),
loose=adj. 宽松的;散漫的;不牢固的;不精确的
lorry=n.卡车
lose=vt. 浪费;使沉溺于;使迷路;遗失;错过
lose heart=丧失勇气(或信心)
loss=n.遗失;损失;失败
lot=n. 命运;一块地;一堆;抽签;份额
loud=adj.(声音)响亮的;喧闹的
love=n. 恋爱;亲爱的;酷爱;喜爱的事物n. 爱人
lovely=可爱的
low=adj.低的
luck=n.运气
lucky=adj.幸运的
luggage=n.(总称)行李
lunch=n.午餐
lung=n.肺,肺脏
machine=n.机器
mad=adj.疯狂的;狂热的
madam=n. 夫人;女士;鸨母
magazine=杂志;期刊
magic=n.魔术;戏法
maid=n.女仆;少女,处女
mail=n. 邮件;邮政,邮递;盔甲
mailbox=邮筒
main=a.主要的
mainland=n.大陆;本土(对岛屿,半岛而言)
mainly=adv.主要地;首要地
major=v. 主修;专研
majority=n.多数;大半
make=n. 制造;构造;性情
make a decision=作出决定(新人初三上)
make a face=(对某人)做鬼脸;扮怪相
make a mistake=犯错误
make a noise=吵闹
make ends meet=使收支相抵,量入为出
make friends with=与……交友
make fun of=取笑;嘲笑
make progress=取得进步
make room for=给…腾出地方
make sense=讲得通,言之有理
make sure=确保;查明
make the bed=铺床
make up=组成;构成
make up one's mind=下决心;决定
make use of=利用某事务(某人)
male=a.男的,雄的 n.男子
mama=n. (口)母亲,妈妈
man=n. 人;男人;人类
manage=v.设法做到
manager=经理
manifesto=n.宣言;声明
mankind=n.［用作单或复］人类
man-made=a.人造的;人工的
manner=n.礼貌;风格;习惯
manners=n.礼貌;规矩
many=pron. 许多;许多人
map=n.地图
march=n. 行军,进军;进行曲;示威游行
mark=n.记号;痕迹
market=市场;市集
marquis=n.侯爵
marriage=n.结婚;婚姻
marry=v.娶,嫁;与....结婚
Marxism=n.马克思主义
mass=n.块, 大多数, 质量, 群众, 大量
masses of=大量,大批
master=n.硕士;(男)主人;能手 vt.控制;掌握
mat=n.垫子
match=v.相配, 相称, 比赛, 相比, 匹配
material=n.材料;原料
math=n. 数学(等于mathematics)
matter=n.事情;材料; 内容
maximum=n.;a.最大(的),最高
may=n.【植】山楂花
maybe=大概,或许
me=我(宾格)
meal=n.膳食的;一餐
mean=v.表示……的意思;作……的解释
meaning=n.意思;含义
means=n.方法;手段;工具
meanwhile=ad.同时,其间,其中
measure=n.尺寸;措施 vt.测量;测度
meat=n. 肉,肉类(食用)
medal=n.奖牌;奖章
media=n.(medium的复数)宣传工具;新闻媒体
medical=a.医学的,医疗的
medicine=药
meet=n. 集会 vt. 满足;遇见;对付
meeting=n. 会议;集会
member=成员
memory=n.记忆力;存贮器
mend=v.修理,修补
mental=adj.精神的;脑力的
mentally=adv.精神上;智力上
mention=v.提及;说起
menu=菜单
merchant=n.商人
merciful=adj.仁慈的,宽大的
mercy=n.怜悯;仁慈
merely=ad.仅仅,只不过
merry=adj. 愉快的;微醉的;嬉戏作乐的
mess=n. 混乱; 食堂; 肮脏; 困境
message=n.消息,音信
metal=n.金属;
metallic=adj.金属的
meter=n. 米;仪表
method=n.方法;办法;方法论
metre=n.公尺;米
microcomputer=n. 微型计算机(研究生32)
midday=n.中午
middle=a.中间的,中等的
midnight=n.午夜(晚上十二点钟)
might=n.力量, 威力, 权力, 能, 可能
mild=adj. 温和的;轻微的;淡味的;文雅的
mile=n.英里
milk=n.乳, 牛奶
million=num.百万
millionaire=n.百分富翁
mind=n.头脑, 智力, 精神
mine=pron. 我的  n. 矿,矿藏;矿山
mineral=adj. 矿物的;含矿物的 n. 矿物
minibus=n.小型公共汽车
minister=n.基督教传教的牧师;部长;大臣
minority=n.少数民族;少数
minus=prep.减(去)
minute=分钟
mirror=镜子
miss=n.过错, 避免, 失败, 小姐, 姑娘
mistake=n.错误;过失;误解
misunderstand=vt. 误解;误会
misunderstanding=n.误会,误解
mix=n.混合
mixture=n.混合;混合物
mobile=adj.(可)动的;可移动的
model=n.模型
modern=adj.现代的;现代化的
modest=adj.谦虚的;谦让的
mom=妈妈(口语)
moment=n.片刻,一会儿
Monday=星期一
money=n.钱,货币
moneylender=n. 放债者
monitor=n.班长
monkey=n. 猴子;顽童
monsieur=n.先生(法)
month=月
mood=n. 情绪,语气;心境;气氛
moon=n.月亮
moral=a.道德的
more=adv. 更多;此外;更大程度地
more or less=大约;左右;或多或少
morning=早晨;上午
mosquito=蚊子
most=adj.最多的, 多数的, 大部分的
mother=n. 母亲;大娘;女修道院院长
motherland=祖国
motivation=n.行为的动机,积极性
motor=n.发动机,马达;汽车
motto=n.座右铭;格言;题词
mountain=n. 山;山脉
mountainous=a.多山的;如山的,巨大的
mourn=vt.哀悼;哀痛
mouse=n. 鼠标;老鼠;胆小羞怯的人
moustache=n.(嘴唇上面的)胡子
mouth=n. 嘴;vt. 喃喃地说, 心不在焉地说
mouthful=n.满口;一口
mouth-to-mouth=(人工呼吸)口对口的(新人初二下)
move=v.移动;搬动
move on=继续前进
movement=n.运动;动作;运转
movie=电影
Mr=先生
Mrs=夫人;太太
much=pron.& ad.许多
mud=n. 泥;烂泥;泥浆
multiple=a.多重的,多样的
multiply=v.(将…)乘…
murder=v.&n.谋杀;凶杀
museum=博物馆
music=音乐
musical=adj.(关于)音乐的
musician=n.音乐家
must=v.必须,应该
my=我的
myself=我自己
nail=n.指甲; 钉子 vt.钉住
name=n. 名称,名字;姓名;名誉
narrow=adj. 狭的;狭窄的;狭隘的
nation=n.国家,民族
national=a.国家的;民族的
nationality=n.国籍
nationwide=全国性的,遍及全国的
native=adj.本地的;本国的
natural=adj.自然的;自然界的
nature=n. 自然;性质;本性;种类
navy=n.海军
near=adv. 近;接近
nearby=adj.位置近的;附近不远的
nearly=adv.几乎, 密切地
neat=adj.整洁的, 灵巧的, 优雅的
neatly=ad.整洁地
necessary=adj.必要的;必须的
neck=n. 脖子;衣领;海峡
necklace=n.项链,项圈
need=v.需要
needle=n.针;缝针
negative=adj. 消极的;否定的
neighbour=邻居
neighbourhood=n.邻近,附近,周围
neither=ad.也不
nephew=n.侄子,外甥
nervous=a.紧张的
nest=n. 巢,窝;安乐窝;温床
net=n.网  vt. 用网捕
network=n. 网络;网状系统;广播(或电视)网
never=adv.决不, 从未
never mind=不要紧,没关系
new=adj. 新的,新鲜的;更新的;初见的
news=n.消息;新闻
newspaper=n.报纸
next=adj.下次的, 其次的, 与...连接, 下一个
nice=adj. 精密的;美好的;细微的;和蔼的
nicotine=n.尼古丁
niece=n.侄女;外甥女
night=n. 夜晚,晚上;黑暗,黑夜
nine=num. 九;九个
ninety=num.九十
ninth=第九
no=不;不是
no longer=不再,已不
no more=不再;再也没有
no more than=仅仅,只是
noble=adj.高尚的;高贵的
nobody=没有人;没人
nod=n.点头
noise=n.喧闹声,嘈杂声
noisy=吵闹的
none=pron. 没有人,没有一人; 没有一个adj. 没有的
non-violent=a.非暴力的
noodle=面条(常用复词)
noon=n. 中午;正午;全盛期
nor=conj.也不
normal=adj.正常的;正规的
north=n. 北,北方
northern=a.北部的
nose=n. 鼻子;嗅觉;突出的部分;探问
not=adv.不;不是的
not at all=一点也不
not only...but also=不但…而且
not...any more=不再;已不
note=vt.注意, 记录, 笔记
notebook=笔记本
nothing=没什么;一个都没有
notice=v.看到,注意到
noun=n. 名词
novel=n.(长篇)小说
novelist=n.小说家
November=十一月
now=adv.现在
now and then=时而;不时;偶尔
now that=既然,由于
nowadays=ad.现今;在这时代
nowhere=ad.到处都没有
nuclear=a.核子的;原子能的
number=n.数字,号码
nurse=n.护士, 保姆
nursery=n.保育室;育儿室
nut=n. 螺母,螺帽;坚果
obey=v.服从,顺从
object=n.物体, 目标, 宾语, 对象
observe=vt. 观察;察觉到;遵守;庆祝(节日等)
obtain=vi. 获得;流行
obvious=adj. 显然的;明显的
obviously=ad.显然地
occasion=n.场合;时机;机会
occasionally=ad.偶尔;间或
occupation=a.职业的; 军事占领的
occupy=vt.占领;担任;使从事
occur=v.发生
ocean=n.海洋
o'clock=钟点
October=十月
of=prep…….的
of course=当然;自然
of one's own=属于某人自己的
off=距;离;离开
offer=v.提供
office=办公室
officer=n.公务员;(政府)官员;军官
official=n.政府官员;高级职员
often=常常;经常
oh=啊;噢
oil=油
old=adj. 陈旧的,古老的;年老的
Olympic=奥林匹克;
Olympic Games=奥林匹克世界运动会(简称奥运会)(新初八下)
on=在…上面
on average=平均地
on board=在船上
on fire=失火
on foot=步行;在进行中
on holiday=在度假
on one's own=独自地;主动地
on one's way to=在…的途中
on show=展出
on the air=正在播出的
on the right=在右边
on time=准时
on top of=在…之上;除…之外
once=一次
once again=再一次
once in a while=间或,偶尔
once more=再一次,又一次
once upon a time=(故事的开头)从前
one=num. 一;一个
one after another=一个接一个地,依次地
one another=互相
one day=(过去或将来的)某一天
oneself=pron.自己
onion=n. 洋葱;洋葱头
only=只有;仅仅
onto=prep.在…上面;到…上面
open=打开
open up=打开
opening=n.最初;空地;洞,孔,通道;(职位的)
operate=vt. 操作;经营;引起;对…开刀
operation=n.[常用复]作战,动作,手术,操作
operator=n.接线员
opinion=意见;看法
oppose=vt.反对;反抗
opposite=adj. 对立的;相反的;反对的, 敌对的
optimistic=a.乐观的
or=conj.或者,还是
or else=否则
or so=大约
oral=a.口头的;口述的
orange=橙色(的)
orbit=n.(天体等的)运行轨道
order=点菜
ordinary=a.普通的;通常的
organ=n.器官
organise=vt./vi.组织;组织起来
organization=n.组织;机构;团体;系统
organize=v.组织
organizer=n.组织者
origin=n.起源,由来;出身
original=adj.新颖的
other=pron.另外的人(物);其他的
otherwise=ad.不然;否则
ouch=int. 哎哟(突然疼痛时发出的声音)
ought=v.aux.应当;应该
ought to=应当;应该
our=我们的
ours=我们的
ourselves=pron. 我们自己
out=prep. 向;离去 adv. 出现;在外;出局
out of=在…外;离开,从…里出来
out of breath=喘不过气来
out of work=失业;(机器)有毛病
outdoor=adj. 户外的;在户外的
outdoors=adv.在外的,在野外的
outer=a.外部的;外面的
outing=n.郊游;远足
outline=n.轮廓;要点;概要
output=n.产量;输出量;输出
outside=ad.外面
outstanding=adj. 杰出的;出色的
over=adv. 结束;越过;从头到尾
over and over=一再地,再三地
over there=在那里(指较远处)
overcoat=n.外衣,大衣
overcome=vt.战胜,克服
overlook=vt.俯视;忽略
owe=vi.欠(债等);感激;把…归功于
own=自己的
owner=n.业主,所有者
ownership=n.所有制
ox=牛
oxygen=n.氧, 氧气
p.m.=(缩)下午;午后(新人初一上)
pace=n.(一)步;速度;步调vi. 踱步;缓慢而行
pack=vt. 包装;压紧;捆扎;挑选;塞满
package=n.包裹;包 vt.包装
packet=n.小包,包裹;群,组
packs of=大量的;一大堆的
page=n. 页;记录;大事件,时期;男侍者
pain=n.疼痛,疼
painful=a.疼痛的;痛苦的
paint=v.油漆, (用颜料等)画,  描绘, 逼真地描述
painter=n.画家
painting=绘画
pair=n. 一对,一双,一副
palace=n.宫殿
pale=adj. 苍白的;无力的;暗淡的
pan=n.平底锅
pancake=煎饼
panel=n.控制板;电池帆板
panic=n.恐慌,惊恐
paper=n. 纸;论文;文件;报纸
paperwork=文书工作
paragraph=n.段落
parcel=n.包裹
pardon=v.原谅(某人);宽恕
parent=n.父亲或母亲
Paris=巴黎
park=n. 公园;(交) 停车场
parrot=鹦鹉
part=n.部分, 局部, 零件, 角色
participate=vi.参与;参加
particular=adj.独特的;特殊的
partly=adv.部分地
partner=n.伙伴;合作者
part-time=adj. 兼职的
party=预付
pass=n. 及格;经过;护照;途径
pass by=从…旁走过;忽视
passage=n. 段落;走道
passenger=n.乘客;旅客
passerby=n.过路人,行人(研究生32)
passive=a.被动的,守势的
passport=n.护照,通行证,执照
past=prep.(时间)超过
path=n. 道路;小路;轨道
patience=n.坚韧,耐性,忍耐力
patient=adj.有耐心的;忍耐的
pattern=n.方式,模式
pause=n.中止;暂停
pay=v.付钱;支付
pay back=偿还,报答
pay off=还清(债务等);付清
peace=n.和平;和睦;安宁
peaceful=adj.平静的;宁静的;和平的
peacefully=ad.安静地
peach=n. 桃子;桃树;桃红色
pear=n. (园艺) 梨树;梨子
peasant=n.农民
pen=n. 围栏, 围圈, 作家
pencil=铅笔
penny=n.(英国)便士
pension=n.养老金
people=人;人民
pepper=胡椒(粉)
per=prep. 每;每一;按照
percent=n.百分比;百分数
percentage=n.百分数; 比例; 部分
perfect=adj.完美的;理想的
perform=v.演出;表演
performance=n.演出;成果;成绩
performer=n.演员;演出者;演奏者
perhaps=ad.也许,可能
period=n.时间;时期;时代
permanent=a.永久(性)的;固定的 [反]temporary
permission=n.允许;许可;准许
permit=n.通行证, 许可证, 执照
person=人;人物
personal=adj.私人的;个人的
personally=adv.就自己而言
persuade=vt. 说服;劝服;使某人相信
pessimistic=a.悲观的
pest=n.害虫
pet=vi.拥抱, 爱抚, 生气, 发脾气n. 宠物
petrol=n.汽油
phenomenon=n.现象;奇迹
phone=电话
photo=照片
photocopier=n. 复印机
photograph=n.照片;相片
photographer=n.摄影者;摄影师
phrase=n.短语,词语
physical=a.身体的;物质的;物理的
physician=n. 医生;内科医师
physics=n.物理;物理学
pianist=n. 钢琴手;钢琴家
piano=钢琴
pick=v.挑选,拾取
pick out=挑出;辨别出
pick up=拣起;
picnic=野餐
picture=照片
pie=n.馅饼
piece=vt.接合, 修补, 凑合
pig=n.猪
pile=n.大量 v.堆积; 积累
pill=n.药片,药丸
pillow=n. 枕头
pilot=n. 飞行员;飞机驾驶员
pin=n. 大头针,针;栓;琐碎物
pineapple=菠萝
pink=n.粉红色, 石竹花, 化身, 极致, 精华
pioneer=n.先锋
pipe=n.管子;输送管
pity=n.可惜;遗憾;可惜的事
place=地方
plain=adj.平常的;普通的
plan=n.&v.计划;规划;方案
plane=飞机
planet=n.行星
plant=vt. 种植;培养;栽培;安置
plastic=adj.塑料制(的)n.塑料
plate=n. 碟;金属板;金属牌;感光底片
platform=n.讲台;站台
play=vt. 游戏;扮演;演奏;播放;同…比赛
play a trick on=开某人玩笑;欺骗某人
play the piano=弹钢琴
player=n.运动员
playground=操场
playmate=n.游戏伙伴
pleasant=adj.令人愉快的,舒适的
please=请
pleased=a.高兴的;愉快的
pleasure=n.高兴,愉快;乐趣
plenty=adj.很多的;足够的
plenty of=许多,大量
plough=n.犁 vt.犁耕;耕
plus=加上
pocket=n.衣袋, 口袋, 钱, 财
poem=n.诗,韵文
poet=n. 诗人
point=vi. 表明;指向 n. 要点;得分;标点
point out=指出,指明;解释
point to=指向
poison=n.毒药;毒害 vt./vi.毒害;投毒
pole=n. 杆;极点;电极n.波兰人
police=警方;警察
policeman=警察
policy=n.政策,方针,保险单
polish=vt.润色
polite=adj.有礼貌的;客气的
political=adj.政治的;政治上的
politician=n.政治家
politics=n.政治(学)
pollute=v.污染;弄脏
pollution=n.污染,污染物
polonium=n. 钋
pool=n. 联营;撞球;水塘;共同资金
poor=adj. 贫穷的;可怜的
pop=n.取出, 砰然声, 枪击
popular=受欢迎的
population=n.人口
pork=猪肉
port=n.港口, 舱门, 左舷, 避风港, 枪眼
position=位置
positive=adj. 积极的;建设性的;肯定的
possess=vt.占用,拥有(财产)
possession=n. 拥有;财产;领地;自制;着迷
possibility=n.可能(性);可能的事
possible=a.有可能的
possibly=adj.可能地;或许;也许
post=n.邮件,邮政,邮寄;vt张贴, 揭示, 邮递
post office=邮局
postcard=n.明信片
postcode=n.邮政编码
poster=n. 海报,广告;招贴
postman=邮递员
pot=n. 罐;壶;盆;锅
potato=土豆
potential=n.潜力;可能性 a.可能的;有潜力的
pound=n.磅, 英镑, 重击, 鱼塘, 兽栏, 拘留所
pour=n. 倾泻;流出;骤雨
powder=n.粉; 火药 v.洒粉于
power=n. 功率;力量;能力;政权;势力
powerful=adj.强大的;有力的
practical=a.实际的;实践的;实用的
practice=练习
practise=v.实践;练习
prairie=n.大草原;草地
praise=n.赞扬,赞美 vi.赞扬
pray=vi.祈祷;恳求;请
prayer=n.祈祷; 祷文; 恳求
PRC=abbr. 中华人民共和国(People's Republic of China)
precious=a.宝贵的,贵重的;珍爱的
predict=vt.预言,预测,预告
prefer=v.更喜爱;更喜欢
preference=n. 偏爱;喜好;优先
preparation=n.准备;预备
prepare=准备
present=礼物
presentation=n.介绍;赠送;呈现
preserve=vt.保护;保存
president=n.总统, 会长, 校长, 行长【根】sed,se
press=n.压, 按, 印刷, 压力, 拥挤, 紧握, 新闻
pressure=n.压力
pretend=v.假装;佯若
pretty=漂亮的
prevent=v.防止;阻止
previous=a.以前的;先的
price=n.价格
priceless=a.无价的
pride=n.自豪;骄傲
primary=a.初级的,初期的
principle=n.法则;原则,原理
print=v.印刷;印制
printer=n.打印机
printing=n.印刷
prison=n.监狱
prisoner=n.俘虏;失去自由的人;犯人
private=adj.私人的;私有的
prize=奖;奖励
probable=adj.很可能的
probably=a.有可能发生的
problem=n.问题
process=n.过程;制作法
produce=v.生产;制造,产生
product=n.产品;成果
production=n.总产量;产品;生产
profession=n.职业,专业,表白
professional=adj. 专业的;职业的
professor=n.教授
profit=n.益处;利润 vi.得益
programme=n.节目
progress=n.进步;前进
project=方案,项目
promise=n./vt.(有)前途;允诺;答应
promote=vt.促进,发扬;提升
pronounce=v.发…音;正确/清晰地吐(字､音等)
pronunciation=n.(一种语言的)发音;发音法
proper=adj.合适的,适宜的;恰当的
properly=ad.非常;完全地
protect=v.保护,保卫,警戒[同]secure
protection=n.保护;防卫
proud=a.自豪的,得意的
prove=vt.证明;证实
provide=v.提供
province=n.省份
pub=n.小酒店;酒吧
public=n.公众
publish=vt.发表;出版;公布
pull=vt. 拉;拔;拖
pump=n.泵,抽水机,<美俚>心vt. 打气
punish=v.惩罚
punishment=n.处罚
pupil=n.学生
purchase=n. 购买;购置物vt. 购买;购置
pure=a.纯净的;纯粹的
purple=紫色(的)
purpose=n. 目的,意图
purse=n.钱包,钱袋
push=vi. 推;推进;增加;伸展;努力争取
put=vt. 放;表达;移动;安置;赋予
put away=放好,储存…备用
put down=记下;镇压;杀死
put on=穿上;上演;教唆
put out=熄灭
put up=展示;张贴
put...in prison=把…投进监狱
puzzle=v.(使)迷惑, (使)为难, 迷惑不解
puzzled=a.迷惑的,困惑的
pyramid=n.(古代埃及的)金字塔;锥体
quake=n.震动;颤抖
quality=n. 品质;特质
quantity=n.量;数量
quarrel=n.争吵,吵架
quarter=n.四分之一;一刻钟
queen=女王;王后
question=问题
questionnaire=n.调查表
quick=adj. 快的;迅速的
quiet=文静的
quit=vt.离开,退出;停止
quite=adv.相当;十分
quiz=答问比赛;智力测验
rabbit=兔
race=n.竞赛 vt.使全速行进 vi.疾走;竞走
racial=adj.种族的,种族间的,由种族引起的
radiation=n. 放射;发射;辐射;放射物
radio=n.收音机
radioactive=a.放射性的
radium=n.镭
rail=n. 铁轨;扶手;横杆;围栏vi. 抱怨;责骂
railway=n.[英]铁路
rain=vi. 下雨;降雨
rainbow=彩虹
raincoat=雨衣
rainfall=n.一场雨;降雨量
rainy=下雨的
raise=举起
random=a.任意的,随便的
range=vi.平行, 延伸, 漫游
rank=n.顺序;级别;军衔;社会阶层;排
rapid=adj. 迅速的,急促的;飞快的;险峻的
rare=adj.稀有的;珍贵的,罕见的
rate=vt.估价, 认为, 鉴定等级, 责骂
rather=adv.宁愿, 宁可, 更正确, 更合适,<口>当然,
rather than=胜于
raw=a.未经加工的
ray=n.光线,射线,辐射线
reach=v.到达
react=v.反应,起反应,反抗
read=vi. 读;读起来
reading=阅读
ready=adj.有准备的, 准备完毕的, 甘心的, 情愿的
real=a.真正的;真实的
realise=vt.了解;领悟;认识到;使(希望)实现
reality=n. 现实;实际存在的事物;真实
really=真实地;确实
reason=vi.推论, 劝说, 思考
rebuild=vt.重建;复原;改造
receive=v.收到;接受
recent=adj.最近的;近来的
recently=adv.最近
reception=a.接待;招待会;接受
receptionist=n.接待员
recite=vt. 背诵;朗诵
recognise=vt.承认,认可;认出,识别
recognize=vt.识别;认出
recommend=vt. 推荐;介绍;建议
record=n. 记录;(尤指运动中的)最高
recorder=n.记录者;录音机
recover=vi. vt. 恢复;重新找到;弥补
recycle=v.再循环;回收利用
red=红色(的)
redirect=vt.转移呼叫
redirection=n. 转移呼叫
reduce=vt.减少;缩减;简化
refer=vi.提到, 涉及, 查阅, 咨询
refer to=v.查阅;参考;提及
reflect=vi. 反射,映现;深思
reform=vt. & n. 改革;改良;改造
refund=n.归还,偿还额,退款
refuse=v.拒绝,回绝
regard=v.把...视为
regards=n. 问候,致意
regret=n.遗憾;悔恨;抱歉;歉意 vt.为…感到遗
regular=正常的;规则的;有规律的
regularly=adv.规则地;经常地
regulation=n.规则,规章;管理
reject=vt.排斥;丢掉;抛弃
relate=vt.&vi.   有关;涉及
relation=n.亲属;亲戚;关系;联系
relationship=n.亲属关系;关系;联系
relative=n.亲人;亲属
relax=放松
reliable=adj. 可靠的;可信赖的;确实的
relief=n.(痛苦等的)减轻, (债务等的)免除, 救济
religion=n.宗教
religious=adj.宗教的;虔诚的
rely=v.依靠;信赖,对…有信心 [同]trust
remain=n.留下
remark=n.话;评论 vt.&vi.说
remember=牢记;记住
remind=vt.提醒,使想起;使发生联想
remove=vt.移动;搬开
rent=v. 租用;出租
repair=v.修理
repairs=n. 修理工作
repay=vt.偿还;还钱给某人
repeat=vt.重说;重复;背诵 vi.重述 n.重复;重
replace=v.替代;替换
reply=v.回答,答复
report=n.报告, 传说, 谣言, 声誉, 名声, 爆炸声
reporter=记者;通讯员
represent=v. 代表;表示
representative=n.代表
republic=n.共和国
request=n.请求, 要求, 邀请
require=vt. vi. 要求;需要
requirement=n.要求;必要条件
rescue=vt.救,援
research=n.研究,调查
researcher=n.研究人员
reserve=vt.储备, 保存, 保留, 预定, 预约
respect=v.尊敬,尊重
respond=vi.回答;响应
responsibility=n. 责任;责任心;职责
rest=n.休息
restaurant=饭馆
result=n. 结果;成果
retire=v.(使)退休;退职;退役
return=送回;归还
reuse=v.再使用
review=n.复习;回顾
reviewer=n. 评论者(书评作者,报刊评论员)
revision=n.复习;温习
revolution=n.革命;彻底的改革
revolutionary=adj.革命的
reward=n.奖赏
rewrite=vt.重写
rice=n. 稻;米饭
rich=adj. 富有的;肥沃的;昂贵的
rickshaw=n. 人力车
rid=v.使摆脱
ride=vi.骑马,乘车n.骑马,乘车
ridiculous=a.荒谬的,可笑的
right=adj. 正确的;直接的;右方的
right away=立刻;马上
right now=立刻;马上
ring=vi. 按铃;敲钟;回响;成环形
ring back=回复电话
ring off=挂断电话;停止讲话
ring up=打电话
ripe=adj. 熟的,成熟的;时机成熟的
rise=n.(数量或水平的)增加;兴起vi.上升
risk=n.危险
river=n. 河,江
road=n. 公路,马路;道路;手段
roast=v.& n. 烤;炙;焙
rob=v.抢劫
robot=机器人
rock=n.岩石, 暗礁, 石头, 摇动
rocket=n.火箭,【植】芝麻菜; 紫花南芥
role=n.角色
roll=adj.滚动, 滚转, (使)摇摆, (使)摇晃, 卷起
roll over=翻转;倒转
roller=n.滚筒;辊
roof=n. 屋顶;最高处,顶部;最高限度
room=n. 房间;空间;余地;机会
root=n.根;根源
rope=n. 绳,绳索
rose=n. 玫瑰,蔷薇;玫瑰红
rot=vi.腐烂;堕落
rough=a.粗野的,粗俗无礼的
round=a.圆的,球形的
round up=收集,集合
row=n.排, 行
royal=a.王室的,皇家的 n.王室或皇族之一员
rubber=n.橡胶;合成橡胶
rubbish=n.垃圾,废物;废话,胡说八道
rude=adj.粗鲁的,不礼貌的
ruin=n.废墟;遗迹;毁灭;崩溃
rule=n. 统治;规则
ruler=尺子
run=n. 奔跑;赛跑  vi. 经营;奔跑
run away=逃跑;跑掉
run out of=用完;用尽
rush=n.匆促, 冲进, 急流, 灯芯草
Russia=n.俄罗斯
Russian=adj.俄罗斯的;俄罗斯人的
sad=adj. 忧愁的;悲伤的
sadly=ad.难过的;悲哀地
sadness=n. 悲哀;难过
safe=adj.安全的, 可靠的, 有把握的
safety=n.安全;平安
sail=v.航行;驾驶
sailing=n. 航行,航海术,启航
sailor=n.海员,水手
salad=沙拉
salary=n.薪水 vt.给...薪水
sale=n.出售;廉售
salt=n. 盐;风趣,刺激性
salty=咸的
same=a.同样的
sand=n.沙;沙子
sandwich=三明治
satellite=n.卫星
satisfaction=n.满意;快事;赔偿
satisfy=vt.满足;使满意
Saturday=星期六
sauce=酱;调味品
sausage=香肠
save=vt.解救, 保存, 保全, 保留, 节省, 储蓄
say=vi. 讲;表示;念;假定;背诵
saying=n.格言;谚语
scan=vt. 浏览;细看;反复察看
scare=vt.恐吓 vi.受惊吓
scene=n.舞台
scenery=n.风景,景色
schedule=时间表;一览表
scholar=n.学者
scholarship=n.奖学金;学问
school=学校
science=科学
scientific=adj.科学的
scientist=n.科学家
scissors=剪刀
scold=vt.责骂
score=n.(比赛)得分;分数;(测验中)成绩 v.得分
scores of=许多;大量
scream=vi.尖叫;发出尖锐刺耳的声音;(风)呼啸
screen=n. 屏;幕;荧光屏
sea=n. 海,海洋
seal=n.封铅, 封条, 印, 图章, 密封,海豹
seaman=n.水手;海员
seamanship=n. 航海技术
search=v.搜寻;搜索
seashell=n. 海贝壳
seaside=n.海滨(胜地);海边 a.海边的;海滨的
season=n.季节; 暂时
seat=n. 座位;所在地;职位
seaweed=n.海草;海藻
second=秒
secondhand=a.二手的;用过的(新人初三上)
secret=n.秘诀;诀窍;秘密
secretary=n.秘书;书记;文书
section=n.地段,分区
secure=adj.安全的,可靠的
see=v.看见
see sb. off=为某人送行
seed=n.种子 vt.播种 vi.(植物)结实;播种
seek=v.寻找,探索
seem=v.似乎,看似
seize=vt.抓住;逮住;夺取
seldom=adv. 很少;不常
select=vt.&vi.选择;挑选
self=n. 自我,自己,本身
selfish=adj.自私的,利己的
sell=n. 销售;失望;推销术
sell out=卖完;出售货物
semicircle=n.半圆,半圆形体
send=vt. 发送,寄;派遣;使进入;发射
send for=使某人来到;要求将某物取来或送到
send out=发送;派遣;发出请柬
send up=发出;射出;呈递
senior=a.年长的;地位较高的
sense=n.官能, 感觉, 判断力, 见识
sensitive=a.敏感的;灵敏的
sentence=n.句子
separate=v.分;分开
separately=adv.分离地;分别地(新初八下)
separation=n.分离;隔离
September=九月
series=n.连续;系列
serious=adj.严肃的;庄重的
servant=n.仆人;佣人
serve=v.当仆人, 服务, 服役, 供职, 招待, 侍候
service=n.服务;服务性工作
set=v.放, 置, 移动到
set fire to=使燃烧,点燃
set free=释放
set off=激起;引起
set out=出发;上路
set up=建立;创立;开办
set...free=释放
settle=vt.使定居;解决;使平静 vi.安家;定居
settlement=n.解决;殖民,殖民地;定居
settler=n.移民者;定居者
seven=七
several=adj.几个的;数个的
severe=adj.严厉的, 严格的, 剧烈的, 严重的
sew=vt. 缝合,缝上;缝纫vi. 缝纫,缝
sex=n.性别
shade=n.(色彩的)浓淡深浅;暗部;荫;阴凉处
shadow=n.影子; 阴影; 幻影
shake=vi. 动摇;摇动;发抖
shall=v.(我,我们)将要
shallow=adj.浅的;肤浅的
shame=n.羞耻,羞愧;羞辱
shape=n.外形;形状
share=v. 分摊;共享
sharp=a.锐利的;轮廓清晰的;灵敏的
shave=n. 刮胡子;修面;幸免 vi. 剃;刮脸
she=她
sheep=n. 羊,绵羊;胆小鬼
sheet=n. 被单;床单;薄板
shelf=书架
shelter=n.掩蔽;掩蔽处;避身处
shine=n. 光泽;擦亮;晴天 vt. 擦亮 vi. 照耀;显露
ship=n. 船;舰;太空船
shirt=衬衫
shock=n. 休克;震惊
shoe=鞋
shoot=v.投射;发射;射出
shooting=n.射击
shop=n.商店
shop assistant=店员
shopping=购物
shore=n. 海滨;支柱 vt. 支撑,使稳住;用支柱撑住
short=矮的
shortcoming=n.缺点;短处
shot=n.射球,投球
should=应该
shoulder=肩
shout=v.呼喊;呼叫
show=n. 显示;表演;炫耀 vi. 显示;说明;指示
show off=炫耀,卖弄
shower=n.淋浴
shrink=vi.减少;变小
shut=vt.关闭
shy=n.投扔, 乱丢
sick=adj. 厌恶的;病态的;不舒服;渴望的;恶心的
sickness=n.生病; 呕吐, 恶心
side=n. 方面;侧面;旁边
side by side=肩并肩地;同时地
sideway=n. 人行道;小巷
sideways=adv.斜着;斜向一边地
sigh=vi.叹气
sight=n.风景;名胜;情景; 奇观
sightseeing=n.观光;游览
sign=v.签名
signal=n.信号
signature=n.签名
significance=n.意义,意味;重要性
silence=n.寂静;沉默
silent=a.寂寞的,无声的;沉默的
silk=n.(蚕)丝;丝织品,绸
silly=a.傻的,愚蠢的
silver=银牌;
similar=adj.相似的;相仿的
simple=adj.简单的;简易的
simple-minded=adj.头脑简单的;笨的(新高1上)
simply=ad.仅仅;只不过;简单地;完全;简直
since=prep.自从;自……以来
sincerely=adv.真诚的
sing=vi. 唱歌;歌颂;鸣叫;呼号
single=adj.单一的, 单身的, 单纯的, 孤独的
sink=vi. 下沉;消沉;渗透
sir=n.先生,阁下
sister=姐妹
sit=v.坐
situation=情景;形势
six=num.六
size=尺寸
skate=滑冰;滑冰鞋
skill=技能;技巧
skilled=a.技术熟练的
skin=n.皮;皮肤 vi. 愈合;长皮
skirt=短裙
sky=天空
skyscraper=n.摩天大楼
slave=n.奴隶
slavery=n.奴隶制;奴隶;奴隶身份
sleep=睡觉
sleepy=困的
slide=n.滑, 滑动, 幻灯片
slight=adj.微不足道的;纤细的, 瘦小的
slightly=adv.轻微地;细小地
slim=adj. 苗条的;修长的;无价值的
slow=adj.慢的;缓慢的 adv. 慢慢地
small=小的
smart=聪明的
smell=闻,嗅
smelly=adj.发臭的;有臭味的(新高1上)
smile=n. 微笑;笑容;喜色
smoke=v.& n.吸烟
smoker=n. 吸烟者
smooth=adj.光滑的;平静的
snake=n. 蛇;阴险的人
sneeze=v.& n. 打喷嚏
snow=n. 雪,积雪;下雪
so=如此;这样
so as to=以便,以求;以致
so far=到目前为止
so long as=只要,如果;既然
so that=以便;结果是;以致
so...that=如此…以至于
soap=肥皂
soccer=足球
social=adj.社会的;社交的
socialism=n.社会主义
socialist=adj.社会主义的
society=n.社会;社团
sock=n. 短袜;一击
sofa=沙发
soft=柔软的,温和的
software=n.(电脑)软件
soil=n.土壤;土地
soldier=n.士兵,军人
solid=a.固体的;实心的;n.固体
solution=n.解答;解决办法
solve=v.解决;解答(难题)
some=adj. 一些;某一;大约
somebody=pron.某(有)人
somehow=ad.以某种方式,莫名其妙地;不知怎么地
someone=pron.某人
something=pron.某事;某物
sometimes=有时;不时
somewhere=adv. 在某处;到某处
son=n.儿子
song=n.歌,歌曲
soon=adv. 快;不久,一会儿;立刻;宁愿
sooner or later=迟早,早晚,或迟或早
sorrow=n.悲哀;悲痛
sorry=adj.遗憾的, 对不起的, 可怜的, 抱歉的
sort=vt. 将事物分类;整理n. 种类;类型
SOS=n.无线电紧急呼救信号;[口]紧急求救的表示
soul=n.灵魂,心灵;精神
sound=adj.健全的, 可靠的, 合理的n.声音, 语音
soup=n.汤
sour=adj. 酸的;发酵的;刺耳的;酸臭的;讨厌
south=n.南;南方adj.在南方的;南部的
southern=a.南部的
souvenir=纪念品;礼物
sow=n. 母猪 vi.插种;散布;使密布
space=n.间隔;空地;空间,太空v.留间隔,隔开
spare=adj.多余的;空闲的
speak=说(某种语言)
special=特色菜
specialist=n. 专家;专科医生
specific=adj.明确的;详细而精确的
speech=n.演说;讲演;说话;言论
speed=n.速度
speed up=加速
spell=n. 符咒;一段时间;魅力vi. 拼字;轮替
spend=v.度过;花费
sperm whale=抹香鲸(小学六年级下)
spirit=n.精神,心灵;气概;[pl.]心情/情绪;烈
spiritual=adj. 精神(上)的;心灵的
splendid=a.极好的,壮丽的
split=vt.&vi.撕开;切开
spoken=adj.口语的;口说的;口头的
sponsor=n.赞助人,发起人 v.赞助
spoon=n. 匙,勺子;一杓的量
sport=运动
spot=n. 地点;斑点
spread=vt./vi.传播;伸展;展开
spring=春季
spy=n.间谍;密探
square=正方形
squid=鱿鱼
squirrel=松鼠
stable=a.稳固的,稳定的
stadium=体育馆
staff=n.全体职员;职员;工作人员
stage=n. 阶段;舞台;戏剧;驿站
stair=n.楼梯
stamp=vt. 用脚踩踏 n.邮票
stand=v.站,站立
stand for=代表;代替;象征;支持
standard=n.标准 adj.标准的
star=n. 星,恒星;明星;星形物
stare=vi.凝视;盯着看
stare at=盯着
start=v.开始;动身,出发
starvation=n.饥饿; 饿死
starve=vi.饿死 vt.使饿死
state=n.&v.国家,州;情况,状态;声明,陈述
statement=n.声明;陈述
station=车站
status=n.身份;地位
stay=在某处呆着
stay up=熬夜
steadily=ad.稳定地;稳固地
steady=a.平稳的;牢固的
steal=vt. 剽窃;偷偷地做;偷窃
steam=v.冒热气
steel=钢
steep=a.陡峻的;险峻的
step=n.脚步;步骤;措施
stick=粘贴
stick to=坚持,不放弃
still=adv.还是;还;仍然
stomach=胃
stone=n.石头;石块
stop=停下来
stopwatch="n. 记秒表,跑表 
vt. 用秒表测定时间"
storage=n.储存;贮藏
store=商店
storm=n.暴风雨
story=故事
straight=直的
strait=海峡;困难
strange=adj.奇怪的;陌生的
stranger=n. 陌生人;陌生事物;新来者
stream=n.溪;川;流
street=街道
streetcar=n.(美)市内有轨电车
strength=n.力量,力气
strengthen=vt.&vi.加强;变强
stress=v. 加压力于;使紧张 n. 压力;紧张
strict=严格的
strike=v.(钟)鸣;敲(响)
strong=健壮的
struggle=vi.努力;挣扎;奋斗 n.竞争;努力;奋斗
struggle against=与…作斗争,和…斗争
stubborn=adj.顽固的,倔强的
student=学生
studio=n.摄影棚(场);演播室;画室;工作室
study=学习
stupid=a.愚蠢的
style=n.风格
subject=学科
submit=vt.提交,呈递
succeed=成功;达到;完成
succeed in=在…成功
success=n.成就,成功
successful=adj.成功的
such=adj.这样的;这种
such as=例如…
suck=vt.吮吸;舔食
sudden=adj. 突然(发生)的;意外的;迅速的
suddenly=ad.突然地
suffer=vt.遭受, 经历, 忍受
suffer from=遭受(痛苦､疾病､损失等)
suffering=n.痛苦;折磨
sugar=糖
suggest=v.建议;提议
suggestion=建议;意见
suit=n.一套衣服;v.合适, 适合, 相配
suitable=adj.合适的;适宜的
suitcase=手提箱
sum=n.总数, 和, 金额, 算术题
summary=n.摘要,概要,一览
summer=夏季
sun=n.太阳
sunburnt=adj.起晒斑的;晒黑的(新高1下)
Sunday=星期日
sunglasses=太阳镜(复数)
sunlight=n.日光,阳光
sunny=adj.阳光充足的, 照耀的, 快乐的
sunrise=n.日出
sunshine=n.阳光(不可数名词)
super=太棒了
supermarket=超级市场
supper=晚餐
supply=vt.供给;供应 n.供给(量);供应品
support=v.支持;帮助
suppose=v.猜想,料想
sure=adj. 确信的;可靠的;必定的
surface=n.表面;外表
surprise=v.使惊奇;使意外
surprisingly=ad.令人惊讶地
surround=vt./vi.包围;围绕
surrounding=a.周围的
survive=vi.幸存 vt.经历…后还活着;比…活得长
suspect=v.怀疑;觉得n.嫌疑犯
swallow=vt.咽;淹没;吞没 n.吞咽;燕子
sweat=n. 汗;水珠;焦急vi. 流汗,渗出
sweater=毛衣
sweep=v.(swept, swept)扫除;清扫;清除
sweet=甜的
sweet potato=甘薯
swell=v.肿胀;膨胀
swift=a.快的,迅速的
swim=游泳
swing=v.摇摆, 摆动, 回转, 旋转
switch=vt. 转变;改变 n.开关;转换器
symbol=n.象征,标志
sympathetic=a.同情的
sympathy=n.同情(心);同感
symptom=a.症状
system=n. 系统;网;制度;体制
table=n. 桌子;表格;平地层
tail=n. 尾巴;踪迹;辫子;燕尾服
tailor=n.裁缝 vt.裁制(衣服)
take=vi. 拿;获得vt. 拿,取;采取;吃;接受
take a look at=看
take a seat=坐下;就座
take a taxi=乘出租车;打的
take an interest in=对……感兴趣
take away=拿走
take care of=照看;照顾
take charge=掌管,负责,看管
take it easy=不紧张;轻松
take on=呈现,具有
take one's place=坐某人的座位
take part in=参加
take photos=照像
take place=发生
take possession of=占有;占领(
take pride in=对…感到自豪
take the place of=代替,取代
take up=开始从事
tale=n. 故事;传说;叙述;流言蜚语
talent=n.天才;天资;才干
talk=vt. 说;谈话;讨论
talk about=谈论;讨论;议论
tall=adj. 高的;长的;过分的;夸大的
tank=n. 坦克, 战车, 柜, 储水池
tanker=n.油船,坦克手
tap=n.龙头
tape=n. 胶带;磁带;带子;卷尺
target=n.靶子; 目标; 指标
task=n.任务;工作
taste=n. 味道;品味;审美
tax=vt.增添…负担 n.税
taxi=出租车
tea=n.茶, 茶树, 茶叶, 茶点
teach=vt. 教;教授;教导
teacher=老师
team=n. 队;组
tear=n.眼泪 vi. 流泪, 撕破
tear down=弄倒某物;拆除某物
technical=a.技术的;技术上的
technique=n.技术;技巧;方法
technology=n.技术;工艺
teenager=n. 十几岁的青少年;十三岁到十九岁的少年
telegram=n.电报
telegraph=n. [通信] 电报机,电报
telephone=电话
television=n.电视
tell=vt. 告诉,说;辨别;吩咐;断定
tell lies=说谎(新高1下)
temper=n.恶劣的心情,心绪焦躁;性情,脾气
temperature=n.温度
temple=n.庙,寺
temporary=adj.暂时的;临时的
ten=num.十
tend=vt. 照料, 照顾; 护理 vi.伺侯,招待
tennis=网球;网球运动
tense=adj.紧张的, 拉紧的
tent=n.帐篷
term=n.学期, 期限, 期间, 条款, 条件, 术语
terminal=n.终点站
terrible=可怕的
terror=n.恐怖,令人恐怖的事
test=n. 试验;检验
text=n.课文;课本;vt.发短信
textbook=n.课本
than=比;比较
thank=谢谢
thanks to=多亏了......幸亏
that=pron. 那;那个
the=这(那);这(那)些
the day after tomorrow=后天
the day before yesterday=前天
the Nobel Prize=诺贝尔奖
the other day=在不久前某天
the Union=(美国南北战争期间的)联邦政府;美国
the United States=美国
theatre=n.剧院
theft=n.偷窃(行为), 偷窃罪
their=他(她,它)们的
theirs=他(她､它)们的
them=他们;她们;它们
theme=n.主题
themselves=pron.他(她､它)们自己
then=adv. 然后;那么;于是;当时;此外
theory=n. 理论;原理;学说;推测
there=adv. 在那里;在那边;在那点上
therefore=adv.因此,所以
these=这些
they=pron. 他们;它们;她们
thick=厚的
thickly=ad. 厚(浓,密,深)
thief=n. 小偷,贼
thin=adj. 薄的;瘦的;稀薄的;微弱的
thing=东西;物
think=想;思考
think about=想起,想到;考虑,反复思考
think of=想;认为
thinking=n.思索;见解;想法
third=第三
thirst=n.渴,口渴;渴望
thirsty=口渴的
thirteen=十三
thirty=三十
this=这;这个
thorough=a.完全的,彻底的
those=adj. 那些的
though=conj. 虽然;即使;纵然
thought=v.think的过去式
thousand=n.一千
thousands of=成千上万的
thread=n.线
three=三
throat=n. 喉头;喉咙;咽喉
through=穿过;通过
throughout=prep. 遍及;贯穿
throw=投;掷
throw away=扔掉
throw up=抛起;呕出(食物)
thunder=n.雷;轰隆响 vi.打雷,轰隆响
Thursday=星期四
thus=ad.如此;这样
ticket=n.票
tidy=a.整洁的;整齐的
tie=n.领带
tiger=虎
tight=adj.紧的,绷紧的, 吝啬的, 严厉的
till=prep. 直到 conj. 直到...为止
time=n. 时间;时代;次数;节拍;倍数
timetable=n.时间表,时刻表
tin=n. 锡;罐头,罐;马口铁
tiny=adj.极小的;微小的
tip=n. 小费;尖端  vi. 给小费;翻倒;倾覆
tire=vi. 疲劳;厌倦vt. 使…疲倦;使…厌烦
tired=疲倦的
title=n. 冠军;标题;头衔;权利;字幕
to=给;对
to be honest=老实说;说实在的
to one's surprise=使某人惊奇的(是)......
to the point=中肯;扼要
tobacco=n.烟叶;烟草制品;抽烟
today=今天
together=一起
toilet=n.洗手间,厕所
tomato=西红柿
tomorrow=明天
ton=n. 吨;很多,大量
tone=n.色调,光度;风气;音调
tongue=n.舌头;语言;口语
tonight=今晚
too=adv. 太;也;很;还;非常;过度
too...to...=太……以致不能……
tool=n.工具
tooth=n.牙齿
toothache=牙痛
top=n.顶部, 顶端, 极点
topic=n.话题;主题
total=a.总的,完全的 n.总计,合计 [同]complet
touch=vt. 接触;触动;使轻度受害
tough=a.强硬的, 艰苦的, 坚强的, 坚韧的, 强壮的,
tour=n. 旅游,旅行;巡回演出
tourism=n.旅游;观光
tourist=n. 旅行者;游客
toward=prep. 向;对于;为了;接近
toward(s)=prep.朝,向;接近;关于,对于
towel=n. 毛巾,手巾;[纸] 纸巾
tower=n.塔
town=n.镇;城镇
toy=n.玩具
track=n.轨迹, 车辙, 跟踪, 航迹, 足迹, 路, 磁轨
tractor=n.拖拉机
trade=n.贸易;商业
tradition=传统,惯例;
traditional=adj.传统的;惯例的
traffic=n.往来于街道的车辆;交通
train=vt.训练, 培养, 瞄准, (园艺)整枝
trainer=n.训练人;教练
training=n.训练;锻炼
transform=vt.改变;改造;变换
translate=v.翻译,解释
translation=n. 翻译;译文
translator=n.翻译员
transport=n. 输送;运输;运输工具
trap=n.圈套, 陷阱, 诡计, 活板门
travel=旅行
treasure=n.财富;珍宝 vt.珍视
treat=n.宴请, 款待, 请客
treatment=n. 治疗,疗法;处理;对待
tree=n. 树;木料;树状物
tremble=vi. 发抖;战栗;焦虑;摇晃
trial=n.试;试验;审判
trick=n. 诡计;恶作剧;窍门;花招;骗局
trip=n. 旅行;绊倒;差错
troop=n.军队,部队;一群
trouble=n.困难,麻烦
troublesome=a.令人烦恼的,讨厌的
trousers=n.裤子,长裤
truck=n.卡车
true=adj.真实的
trust=v.相信;信任
truth=n.真实,真相;事实;真理
try=vt. 试图,努力;试验;审判;考验
try on=试穿;试用;试验
try one's best=尽力做......
try out=(彻底)试验
tube=n.管;软管
Tuesday=星期二
turn=n.转动, 旋转, 转变方向, 轮流
turn away=将…拒之门外
turn down=调节使音量变小
turn off=关掉
turn on=打开(电器)
turn over=(使)翻倒,(使)倾覆
turn to=开始干;求助于;转向
turn up=出现;找到;证明是
tutor=n.家庭教师
TV=电视
twelfth=第十二
twelve=十二
twentieth=第二十
twenty=二十
twice=两次
twist=n.扭曲;盘旋 vi.扭弯;缠绕
two=二
type=n.类型
typewriter=n.打字机
typhoon=n.台风
typical=a.典型的;象征性的
typist=n.打字员
tyre=n.轮箍; 轮胎, 车胎
ugly=丑的
UK=n.联合王国(新人初一下)
umbrella=雨伞
unable=adj.[后接动词不定式]不能的,不会的
unbelievable=adj. 不可相信的;难以置信的
uncertain=adj.不确定的,易变的
uncle=叔叔
uncomfortable=adj.不舒服的
under=在下面
underground=adj.地下的;秘密的
underline=v.在...下划线,强调
understand=v.懂得,理解
understanding=n.领会;理解
undertake=vt.&vi 着手做;从事;承担
underwater=adj.在水下的;在水中的
undivided=adj. 专心的;专一的;未分开的;完整的
unfair=adj. 不公正的､不公平的
unfold=vt.打开;显露;阐明
unfortunately=adj. 不幸的;倒霉的
unhealthy=adj. 不健康的;不益健康的
uniform=制服;校服
union=n. 联合;合并;结婚;联邦;协会
unique=a.唯一的;独特的
unit=n.个体, (计量)单位, (军队的)部队单位,
unite=联合
united=一致的
universal=a.通用的;普遍的;世界的;全体的
universe=n.宇宙
university=大学
unknown=adj. 未知的;不出名的
unless=conj.  如果不､除非
unlike=prep.不像…;和…不同
unpleasant=adj.使人不愉快的
unreserved=a.没有被预订的
unrest=n.动乱;骚乱;不安
unsuccessful=a.不成功的;失败的
until=conj.(till)直到……之时;在……之前
unusual=adj. 不寻常的;罕有的;独特的
unwilling=a.不愿意的
up=adv. 起来;上涨;向上
up and down=上上下下;前前后后
update=vt.更新;使现代化;为…提供最新消息
upon=prep.在…上
upper=adj.较高的;较上的;上院的;北部的
upset=adj.心烦的;沮丧的
upstairs=ad.楼上
upward=ad.向上
uranium=n.铀
urban=adj. 城市的;都市的
urgent=a.紧迫的;重要的
us=我们(宾格)
use=使用
used=a.用过的;半旧的
used to=过去经常;以前常常
useful=adj.有用的;有益的
useless=a.无用的;无效的
usual=a.通常的,惯例的
usually=通常;一般
vacation=假期
valid=a.有效的;正当的
valley=n.(山)谷;河谷
valuable=a.贵重的;有价值的
value=n.价值;实用性;(pl.)价值观 vt.估价
variety=n.多样化;种类;变化
various=a.各种各样的,不同的
vast=a.巨大的;庞大的
vegetable=蔬菜
vehicle=n.车辆(统称)
Venus=n.维纳斯;美人;色情;金星
verb=n.动词
very=很;非常
via=prep.凭借;通过;经过
victim=n.受害者
victory=n.胜利
video=电视;录像
videophone=n.电视电话
view=n. 观点;想法;态度
viewer=n.观看者
village=n. 村庄;村民;(动物的)群落
villager=n.村民,乡村居民
vinegar=醋
violence=n. 暴力;侵犯;猛烈;强烈
violent=adj.猛烈的,暴力的
violin=小提琴
virus=n. 病毒
visa=n.(护照等的)签证
visit=看望,访问
visitor=客人;参观者
vivid=adj. 生动的;鲜明的;鲜艳的
vocabulary=n.词汇
voice=n.声音
volcano=n.火山
volleyball=排球
volunteer=n.志愿者
vote=v.选举;投票
voyage=n.航行;(尤指)航海;航天
wait=vt. 等候;推迟;延缓
wait for=等候;等待
waiter=(饭店､旅馆､餐厅等的)服务员
waitress=n.女服务生
wake=v.唤醒;弄醒
wake up=醒,唤醒;醒来
walk=n. 步行,走;散步
wall=n. 墙壁,围墙;似墙之物
wallet=钱包,皮夹
wander=vi.漫步, 徘徊, 迷路, 迷失方向, 离题
want=n. 贫穷;贫困;匮乏vt.想要, 希望, 需要
war=n.战争 ;vi. 打仗,作战;对抗
warm=adj. 暖和的, 暖的, 温暖的, 色情的, 激烈的
warmth=n.温暖;热情
warn=v.警告;提醒
warning=n.警报
warship=n.军舰;战舰
wartime=n.战时
wash=vt. 洗涤;洗刷;冲走;拍打
waste=v.浪费;滥用
watch=vt. 观察;注视;看守;警戒
watch over=看守;监视(新高1上)
water=n. 水;海水;雨水;海域,大片的水
watermelon=n. 西瓜
wave=n.波, 波浪, (挥手)示意, 致意
way=n.路
we=我们
weak=adj. 柔弱的,虚弱的; 无力的,软弱的
weakness=n.软弱;弱点
wealth=n.财富, 财产, 大量
wealthy=adj.富有的, 丰裕的, 充分的
wear=穿
weather=n.天气, 气候, 气象;adj.迎风的, 露天的
website=n.站点;网址
wedding=n.婚礼;结婚
Wednesday=星期三
weed=n.杂草,野草 vt.除草;铲除
week=星期
weekend=周末
weekly=a./ad.每周一次(的)
weigh=v.称;称..... 重量
weight=n.重量;分量
welcome=欢迎
welfare=n.幸福,福利
well=adj. 良好的;健康的;适宜的
well-known=adj.有名的;出名的
west=n. 西;西方;西部
western=adj. (在)西方的;来自西方的
westerner=n. 西方人
wet=adj.湿的;潮的
whale=n. 鲸;巨大的东西
what=pron. 什么;多么;多少
whatever=pron.不论什么
wheat=n.小麦, 小麦色, 淡黄色, 朴实的人
wheel=n. 轮子
wheelchair=n.轮椅
when=pron. 那时;什么时侯
whenever=ad.无论何时
where=adv. 在哪里
wherever=adv.无论哪里
whether=ad.是否
which=哪一个
whichever=pron.无论哪个
while=conj.当……的时候
whisper=v.耳语
whistle=n.口哨;口哨声
white=白色(的)
who=谁
whole=完全的,全部的
whom=pron.(who的宾格)谁;什么人
whose=pron. 谁的(疑问代词)
why=adv.为什么
wide=a.宽的
widespread=a.普遍的;分布广的
wife=n.(pl. wives)妻子
wild=adj. 卤莽的;轻率的
wildlife=n. 野生动植物
will=v.将,会;愿意,要
willing=a.心甘情愿的;愿意的
willingly=ad. 自动地,欣然地
win=v.赢;获胜
wind=n. 风;呼吸;气味;卷绕
window=窗户
windy=有风的
wine=n. 酒,葡萄酒;紫红色
wing=n.翅;翅膀;机翼
winner=n.胜利者
winter=冬季
wipe=v.擦,抹,揩
wire=n. 电缆;电线;金属丝
wisdom=n.智慧;学识;明智的行为
wise=adj. 明智的;聪明的;博学的
wish=n.希望;祝愿
with=prep. (表示伴随)与此同时, 随着
withdraw=v.撤退,撤回
within=prep. 在…里面;在…范围之内
without=prep.无;没有;缺少
witness=n.证人;证据
wolf=n.狼
woman=女人
wonder=n.奇迹, 惊奇, 惊愕
wonderful=好极了,奇妙的
wood=n.木材,木头,木料
woodcutter=n.樵夫;伐木工
wooden=adj.木制的;木头似的,呆笨的
wool=n.羊毛;绒线
woollen=n. 毛织品;a. 羊毛制的
word=n.词,单词
work=n. 工作;[物] 功;产品;操作
work out=结局;至最后;结果为
worker=n.工人,工作者,工作人员
workforce=n.劳动力
works=n. 作品;工厂;工程结构
world=n.世界
worldwide=adj.世界性的;世界范围的
worry=vt. 担心;发愁;折磨
worry about=担心(新高1上)
worse=adj.更坏的, 更恶劣的
worst=adj.bad的最高级
worth=a.值钱;值得,具有..价值 n.价值,作用
worthwhile=a.值得花时间的
would=v.will的过去式, 将, 愿意
wound=v.击伤
wrestling=n.摔跤(运动)
write=vi. 写,写字;写作,作曲;写信
write down=写下;把…描写成
wrong=a.错误的;出事,有毛病
X-ray=n. X光照片
yard=n. 院子, 码
year=年
year after year=年年,每年
yellow=adj. 黄色的;黄皮肤的
yes=是;是的
yesterday=昨天
yet=adv. 还; 仍然; 尚
you=你;你们
young=年轻的
your=pron. 你的,你们的
yourself=pron.你自己(反身代词)
youth=n.年轻;青春;表年人
zero=n. 零点,零度
zone=n.区域;地区,划分地带 [同]area
zoo=n.动物园
