by accident=ph.偶然
on account of=ph.因为,由于
in addition=ph.另外 
in addition to=ph.除…之外(包括)
in the air=ph.在流行中,在传播中 
on the average=ph.平均,一般来说
on the basis of=ph.根据,在…的基础上
at the best=ph.充其量,至多
for the better=ph.好转,改善
on board=ph.在船(车､飞机)上
out of breath=ph.喘不过气来
on business=ph.因公,因事
in any case=ph.无论如何,总之
in case of=ph.假使,万一
in case=ph.假如,以防(万一),免得
in no case=ph.决不
by chance=ph.偶然,碰巧
in charge of=ph.负责,主管
a round the clock=ph.昼夜不停地
in common=ph.共用,共有,共同
in conclusion=ph.最后,总之
on condition that=ph.在…条件下
in confidence=ph.信任
in connection with=ph.关于
in consequence=ph.因此,结果
in consequence of=ph.由于…的缘故
on the contrary=ph.反之,正相反
in contrast with=ph.与…成对照
out of control=ph.失去控制
under control=ph.被控制住
at all costs=ph.不惜任何代价
at the cost of=ph.以…为代价
in the course of=ph.在…过程中,在…期间
of course=ph.当然,自然,无疑
in danger=ph.在危险中,垂危
out of danger=ph.脱离危险
out of date=ph.过期(时)的
up to date=ph.时新的
in debt=ph.欠债
in detail=ph.详细地
in difficulties=ph.处境困难
in the distance=ph.在远处 
off duty=ph.下班
on duty=ph.值班,上班
on earth=ph.究竟,到底
at all events=ph.无论如何
in any event=ph.无论如何
in effect=ph.有效,实际上
in the event of=ph.万一,如果发生
for example=ph.例如
with the exception of=ph.除…之外
in the face of=ph.面对,不顾,即使
in fact=ph.其实,实际上
on fire=ph.烧着
on foot=ph.步行
in force=ph.有效,实施中
in favour of=ph.有利于,赞成,支持
in front of=ph.在…面前
in the future=ph.今后,将来
on guard=ph.警惕,防范
in general=ph.通常,大体上
in half=ph.成两半
at hand=ph.在手边,在附近
from tip to toe=ph.彻头彻尾,完全
by hand=ph.用手
hand down to=ph.往下传,传给(后代)
hand in hand=ph.手拉手,携手
in hand=ph.在掌握中,在控制中
on hand=ph.在手边,临近
on the one hand…=ph.一方面…,
on the other hand=ph.另一方面…
at heart=ph.在内心,实质上
by heart=ph.牢记,凭记忆
at home=ph.在家,在国内,自在,自如
in honor of=ph.以纪念,向…表示敬意
on one's honor=ph.以名誉担保
in a hurry=ph.匆忙地,立即
for instance=ph.例如,举例说
at intervals=ph.不时,时时
at last=ph.最终,终于
at least=ph.至少,最低限度
in the least=ph.一点,丝毫
at length=ph.终于,最后,详细地
in the light of=ph.按照,根据
in line=ph.成一直线,排成一行
in line with=ph.与…一致,按照
at a loss=ph.困惑,不知所措
by all means=ph.无论如何,必定
by means of=ph.借助于,用
by no means=ph.决不
in memory of=ph.纪念
at the mercy of=ph.在…支配下
by mistake=ph.错误地
at the moment=ph.现在,此刻
for a moment=ph.片刻,一会儿
for the moment=ph.现在,暂时
in a moment=ph.立刻,马上
in nature=ph.本质上
on occasion=ph.有时,不时
in order=ph.秩序井然,整齐
in order to=ph.以便,为了
in order that=ph.以便
out of order=ph.发生故障,失调
on one's own=ph.独自地,独立地
in particular=ph.特别地,尤其,详细地
in the past=ph.在过去,以往
in person=ph.亲自
in place=ph.在适当的位置
in place of=ph.代替
in the first place=ph.起初,首先
in the last place=ph.最后
out of place=ph.不得其所的,不适当的
on the point=ph.即将…的时候
to the point=ph.切中要害,切题
in practice=ph.在实际中,实际上
out of practice=ph.久不练习,荒疏
at present=ph.目前,现在
for the present=ph.目前,暂时
in proportion to=ph.(与…)成比例的
in public=ph.公开地,当众
for the purpose of=ph.为了
on purpose=ph.故意,有意
with the purpose of=ph.为了
in question=ph.正在考虑
at random=ph.随意地,任意地
at any rate=ph.无论如何,至少
by reason of=ph.由于
as regards=ph.关于,至于
with regard to=ph.对于,就…而论
in relation to=ph.关系到
with respect to=ph.关于
as a result=ph.结果,因此
as a result of=ph.由于…的结果
in return=ph.作为报答,作为回报
on the road=ph.在旅途中
as a rule=ph.规章,规则,通常,照例
in the long run=ph.最终,从长远观点看
for the sake of=ph.为了…起见 
on sale=ph.廉价出售,出售,贱卖
on a large scale=ph.大规模地
on a small scale=ph.小规模地
in secret=ph.秘密地,私下地
in a sense=ph.从某种意义上说
in shape=ph.处于良好状态
on the side=ph.作为兼职,额外
at first sight=ph.乍一看,初看起来
in sight=ph.被看到,在望
out of sight=ph.看不见,在视野之外
in spite of=ph.不管,不顾,尽管,虽然
on the spot=ph.当场,在现场
in step=ph.同步,合拍
out of step=ph.步调不一致,不协调
in stock=ph.现有,备有
in sum=ph.总而言之 
in tears=ph.流着泪,含泪,哭
in terms of=ph.依据,按照,用…措词
for one thing=ph.首先,一则
on the second thoughts=ph.经重新考虑,一转念
at a time=ph.每次,一次
at no time=ph.从不,决不
at one time=ph.同时,曾经,从前曾
at the same time=ph.但是,然而,同时
at times=ph.有时
for the time being=ph.目前,暂时
from time to time=ph.有时,不时
in no time=ph.立即,马上
in time=ph.及时,适时地
on time=ph.准时
on top of=ph.在…之上
out of touch=ph.失去联系
in truth=ph.事实上,实际上,的确
on try=ph.试穿
by turns=ph.轮流,交替地
in turn=ph.依次,轮流
in vain=ph.徒劳,无效
a variety of=ph.种种,各种
by virtue of=ph.由于
by the way=ph.顺便提一下,另外
by way of=ph.经由,通过…方式
in a way=ph.在某点,在某种程度上
in no way=ph.决不
in the way of=ph.妨碍
in one's way=ph.妨碍,阻碍
after a while=ph.过了一会,不久
for a while=ph.暂时,一时
on the whole=ph.总的来说
in a word=ph.总而言之
in other words=ph.换句话说,也就是说
at work=ph.在工作,忙于
out of work=ph.失业
in the world=ph.到底,究竟动词+名词形式
have access to=ph.可以获得
take into account=ph.考虑
gain an advantage over=ph.胜过,优于
pay the way for=ph.为…铺平道路
take advantage of=ph.利用,趁…之机
pay attention to=ph.注意
do one's best=ph.尽力,努力
get the best of=ph.胜过
make the best of=ph.充分利用,妥善处理
get the better of=ph.打败,致胜
catch one's breath=ph.屏息,歇口气
take care=ph.小心,当心
take care of=ph.照顾,照料
take a chance=ph.冒险一试
take charge of=ph.担任,负责
keep company with=ph.与…交往
take delight in=ph.以…为乐
with delight=ph.欣然,乐意地
make a difference=ph.有影响,很重要
carry into effect=ph.使生效,使起作用
put into effect=ph.实行,生效
come into effect=ph.生效,实施
take effect=ph.生效,起作用
catch one's eye=ph.引人注目
keep an eye on=ph.留意,照看
make faces=ph.做鬼脸
find fault=ph.埋怨,挑剔
catch fire=ph.着火
come into force=ph.生效,实施
make friends=ph.交朋友,友好相处
be friends with=ph.对…友好,与…交上朋友
make fun of=ph.取笑,嘲弄
keep one's head=ph.保持镇静
lose one's head=ph.不知所措
lose heart=ph.丧失勇气,失去信心
get by heart=ph.记住,背诵
get hold of=ph.抓住,掌握
keep house=ph.管理家务,做家务
throw light on=ph.使明白,阐明
keep in mind=ph.记住
have in mind=ph.记住,考虑到,想到
make up one's mind=ph.下决心
come into operation=ph.使投入生产,使运转
put in order=ph.整理,检修
hold pace with=ph.跟上,与…同步
play a part=ph.起作用
take place=ph.发生,进行
take the place of=ph.代替
come to the point=ph.说到要点,扼要地说
bring into practice=ph.实施,实行
make progress=ph.进步,进展
give rise to=ph.引起,使发生
make sense=ph.讲得通,有意义
catch the sight of=ph.发现,突然看见
go on the stage=ph.当演员
take one's time=ph.不急不忙,从容进行
keep in touch=ph.保持联系
keep track=ph.通晓事态,注意动向
lose track=ph.失去联系
make use of=ph.利用
put to use=ph.使用,利用
give way=ph.让路,让步
lead the way=ph.带路,引路
make one's way=ph.前进,进行
make way=ph.让路,开路
keep one's word=ph.遵守诺言
act on=ph.作用
appeal to=ph.呼吁,要求
attempt at=ph.企图,努力
attitude to=ph.态度,看法
a great deal of=ph.大量(的),许多(的)
influence on=ph.影响
interference in=ph.干涉
interference with=ph.妨碍,打扰
introduce to=ph.介绍
a lot of=ph.许多(的),大量(的)
lots of=ph.大量,很多
fall in love with=ph.相爱,爱上
a matter of=ph.(关于…)的问题
a number of=ph.若干,许多
reply to=ph.回答,答复
a series of=ph.一系列,一连串
trolley bus=ph.无轨电车
ID card=ph.身份证
credit card=ph.信用卡
no doubt=ph.无疑,必定
next door=ph.隔壁
out of doors=ph.在户外
face to face=ph.面对面地
as a matter of fact=ph.实际情况,真相
a few=ph.有些,几个
quite a few=ph.还不少,有相当数目的
a little=ph.一点,稍微,一些,少许
little by little=ph.逐渐地
quite a little=ph.相当多,不少
no matter=ph.无论
the moment that=ph.一…就
no more=ph.不再
fair play=ph.公平竞赛,公平对待
in demand=ph.有需要,销路好
rest room=ph.厕所,盥洗室
primary school=ph.小学
side by side=ph.肩并肩,一个挨一个
heart and soul=ph.全心全意
step by step=ph.逐步
ahead of time=ph.提前
all the time=ph.一直,始终
once upon a time=ph.从前
once in a while=ph.偶尔,有时
no wonder=ph.难怪,怪不得
word for word=ph.逐字地
decline with thanks=ph.婉言谢绝
account for=ph.说明(原因等)
aim at=ph.瞄准,针对
allow for=ph.考虑到
appeal to=ph.呼吁,要求
arrive at=ph.达成,得出
ask after=ph.询问,问候
ask for=ph.请求,要求
attach to=ph.附属于,隶属于
begin with=ph.从开始
break into=ph.闯入
break off=ph.断绝,结束
break through=ph.突破
break up=ph.中止,结束,打碎,折断
bring about=ph.带来,造成
bring down=ph.打倒,挫伤,降低
bring forth=ph.产生,提上
bring forward=ph.提出
bring out=ph.使出现,公布,出版
bring up=ph.教育,培养,使成长
build up=ph.积累,堵塞,树立,逐步建立,增进,锻炼
call for=ph.邀请,要求,需求
call forth=ph.唤起,引起,振作起,鼓起
call off=ph.放弃,取消
catch at=ph.抓住(东西)
call on=ph.访问,拜访,号召,呼吁
call up=ph.召集,动员,打电话
care for=ph.照管,关心,喜欢,意欲
carry off=ph.夺去
carry on=ph.继续下去,从事,经营
carry out=ph.贯彻,执行,实现
come to=ph.总计,达到,苏醒,复原
count on=ph.依靠,期待,指望
count up=ph.把…相加
cover up=ph.掩饰,掩盖
cut across=ph.走捷径,抄近路
deal with=ph.处理,对付,安排
do without=ph.没有…也行
fill in=ph.填充,填写
get at=ph.得到,接近,意思是
get into=ph.进入,陷入
go after=ph.追求
go into=ph.进入,研究,调查
go for=ph.竭力想取得,喜爱,支持,拥护
go through=ph.经历,经受,详细检查
go with=ph.伴随,与…协调
go without=ph.没有…也行
improve on=ph.改进
keep to=ph.保持,坚持
lie in=ph.在于
live up to=ph.不辜负
live on=ph.…生活,以…为食
live through=ph.度过,经受过
look after=ph.照管,照料
look at=ph.看望,注视
look for=ph.寻找,寻求
look into=ph.调查,观察,过问,窥视
look over=ph.检查,查看,调查
look through=ph.仔细查看,浏览,温习
make for=ph.走向,驶向,有助于
occur to=ph.被想到,被想起
play with=ph.以…为消遣,玩弄
refer to=ph.参考,查阅,涉及,提到
run for=ph.竞选
run into=ph.撞上,偶然碰见
see to=ph.注意,负责,照料,修理
send for=ph.派人去请,召唤,索取
send in=ph.呈报,递交,送来
serve as=ph.作为,用作
set aside=ph.挑出,拨出,留出,拒绝
sit for=ph.参加
stand by=ph.支持,帮助,袖手旁观
stand for=ph.代替,代表,意味着
stand against=ph.反抗,抵抗
stick to=ph.坚持,忠于,信守
take after=ph.与…相像
take for=ph.把…认为是,把…看成是
take in=ph.接受,吸收,了解,理解
take to=ph.喜欢,亲近
touch on=ph.关系到,涉及
turn into=ph.变成
turn to=ph.变成,求助于,借助于
turn off=ph.关上,出产,解雇
