absolute maximum=绝对最大值
absolute minimum=绝对最小值
absolutely convergent=绝对收敛
absolute value=绝对值
acceleration=加速度
alternating series=交错级数
angle=角
antiderivatives=反导数
approach=趋近
arc length=弧长
argument=辐角
average value=平均数
bounded above=有上界的
bounded below=有下界的
bounded sequence=有界数列
calculus=微积分
cardioid=心脏线
center of mass=质心
Chain Rule=链式法则
closed interval=闭区间
coefficient=系数
Complex numbers=复数
Conclusion(delete)=结论(delete)
conditional inequality=条件不等式
coordinate=坐标 
coordinate axis=坐标轴
curvature=曲率
coplanar=共平面
conic section=二次曲线
Completeness Axiom	=完备性公理
contradictory linear equations=矛盾方程组
cycloid=摆线
conditionally convergent=条件收敛
critical number=临界值
converge=收敛
cylinder=圆柱体,柱体
cross-section=横切面
curve sketching=曲线描绘
curve=曲线
concave downward=凹向下
concave upward=凹向上
composite function=合成函数
domain=定义域
denominator=分母
derivative=导数
dependent linear equations=相依方程式
discriminant=判别式
difference set=差集
dividend=被除数
divisor=除数
divergent=发散
differentiation=微分
discontinuity=不连续
decay=衰变
decimal=小数
decreasing=递减
dimensional=维数
dot product=点积
direction angle=方向角
direction cosine=方向余弦
determinant=行列式
direction number=方向数
density=密度
double integrals=双重积分
exponent=指数
exponential law=指数率
exponential function=指数函数
extreme values of functions=函数的极值
expression=函数表示法
even function=偶函数
empty set=空集合
equation=方程式
ellipse=椭圆
ellipsoid=椭球
Fibonacci sequence=费伯纳希数列
four-leaved rose=四叶玫瑰
function=函数
graphical solution=图解法
Gaussian function=高斯函数
geometric series=几何级数
global maximum=全局最大值
global minimum=全局最小值
gradient=斜度, 变化率
half-life=半衰期
harmonic function=调和函数
harmonic series=调和级数
helix=螺旋线
horizontal asymptote=水平渐进线
hypotenuse=斜边
hypothesis=假设
hyperbola=双曲线
hyperbolic function=双曲函数
implicit differentiation=隐函数微分
implicit function=隐函数
improper integral=瑕积分
increasing=递增
indefinite integral=不定积分
indeterminate form=不定型
infinite series=无穷级数
inflection point=反曲点
initial point=起点
inner product=内积
Instantaneous velocity=瞬时速度
integrable=可积分
integration=积分
integrand=被积函数
integration by parts=分部积分
intercept=截距
interval of convergence=收敛区间
inverse function=反函数
Inverse trigonometric function=反三角函数
infinity=无限大
irrational number=无理数
inference=推理
interval=区间
integral exponent=整数指数
