above all=ph. 最重要的
all at once=ph. 突然
all day long=ph. 整天,全日
all of a sudden=ph. 突然
all right=ph. 没关系,可以
all the same=ph. 同样地,仍然,依然
as a matter of fact=ph. 事实上,其实
as a result=ph. 因此,结果
as for=ph. 至于,有关(置于句首)
as if=ph. 彷佛
as long as=ph. 如果,只要
as soon as=ph. 一…就…
as though=ph. 彷佛
as to=ph. 至于,有关
as usual=ph. 照常,仍然
as yet=ph. 到目前为止
at all=ph. 丝毫,极少
at first=ph. 起先
at last=ph. 最后,终于
at least=ph. 至少
at once=ph. 立刻
at stake=ph. 得失攸关,濒于危险
at times=ph. 有时候
attend to=ph. 照顾
be cheated=ph. 受骗(被动)
be constant=ph. 依附,坚持,固守
be revenged on=ph. (~ sb.)报仇
beside oneself=ph. 发狂,忘形
beware of=ph. 当心,注意
beyond question=ph. 毫无疑问的
blow out=ph. 轮胎爆裂
bring back=ph. 从他处拿来
bump into=ph. 偶然遇到,无意中发现
burn the midnight oil=ph. 迟睡,熬夜
by heart=ph. 熟记
by oneself=ph. 靠自己,独立
by the way=ph. 顺便一提
can not but=ph. 不得不
cause a stir=ph. 引起轩然大波
cheat sb.=ph. 欺骗某人(主动)
come across=ph. 碰撞,不期而遇
come to=ph. 使复苏,使苏醒
come to one's aid=ph. 前来援助某人
come upon=ph. 偶然遇到,无意中发现
compare A to B=ph. 将A比喻为B
compare A with B=ph. 比较A与B
cool down=ph. 变冷静
day after day=ph. 每天,一天又一天
day in, day out=ph. 每天,一天又一天,(同day after day)
deceive sb.=ph. 欺骗某人(主动)
depart for=ph. 动身,起程
do one's best=ph. 尽力(做…)
every now and then=ph. 偶尔,(同every so often)
every so often=ph. 偶尔
fill out=ph. 填写
for a while=ph. 一会而
for good=ph. 永久,永远
for the time being=ph. 目前,暂时
from then on=ph. 从那时起
generally speaking=ph. 大致上,大体上,就全体而论
get along=ph. 前进,进展
get off=ph. 下车(船,飞机)
give in=ph. 屈服,让步
go to sea=ph. 做水手,航海
grow up=ph. 长大,成人
had better=ph. 最好
hand in=ph. 缴交
hand over=ph. 移交
happen to=ph. 发生
happen to meet=ph. 偶然遇到,无意中发现
have no choice but=ph. 不得不 ,忍不住,禁不住
have talent for=ph. 使…适合,有…的才能
head for=ph. 前往某地,(同bound for)
in a hurry=ph. 急忙,慌忙
in addition=ph. 此外,而且
in addition to=ph. 此外,而且,除…外
in favor of=ph. 赞成
in general=ph. 大致上,大体上,就全体而论
in no way=ph. 絶不,一点也不
in the long run=ph. 终于
in the past=ph. 在过去,向来
in time=ph. 及时
in vain=ph. 无效,徒然
inside out=ph. 翻转
irregularly=ph. 断断续续地
It is not long before …=ph. 过了不久就…
It stands to reason=ph. (~ that 子句)显然
keep up with=ph. 赶上,保持…一样的速度
leave for=ph. 前往某地,(同bound for)
leave sth. alone=ph. 听任,别管,避开
lessen in intensity=ph. 使强度减轻,调和
let alone=ph. 更不必说,遑论
little by little=ph. 渐渐地,慢慢地
make a long face=ph. 不高兴
make faces at=ph. (~ sb.)对…扮鬼脸
make for=ph. 前往某地,(同bound for)
name…after=ph. 以…命名,以…取名
never mind=ph. 没关系,不要紧
nine out of ten=ph. 十之八九,非常可能地
no longer=ph. 不再…
no matter=ph. 不论
now and then=ph. 断断续续地
off and on=ph. 断断续续地
on and off=ph. 断断续续地
on no account=ph. 决不
on purpose=ph. 故意,蓄意
on the alert=ph. 注意
on the way=ph. 在途中
on the whole=ph. 大致上,大体上,就全体而论
on time=ph. 准时
once and for all=ph. 断然地(只此一次下不为例)
once in a while=ph. 偶尔
out of=ph. 没有,出自
out of date=ph. 过时的
out of order=ph. 故障
out of question=ph. 毫无疑问的
over and over=ph. 反复,再三地
over and over again=ph. 反复,再三地
pass away=ph. 去世,死去
place upside down=ph. 翻转,颠倒,移交
provided that=ph. 惟,如果,只要,(同as long as)
pull a face=ph. 扮鬼脸
pull a long face=ph. 不高兴
put up with=ph. 容忍
quite a few=ph. 很多,不少
rain or shine=ph. 不论晴雨
revenge oneself on=ph. (~ sb.)报仇
right away=ph. 立刻
ring back=ph. 回电
ring off=ph. 挂断电话
rob sb. of sth.=ph. 抢劫(某人)
rule out=ph. 排除,否絶
run across=ph. 碰撞,不期而遇
run into=ph. 偶然遇到,无意中发现
set out for=ph. 前往某地,(同bound for)
show-off=n. 自大的人
sit up=ph. 迟睡,熬夜
smaller and smaller=ph. 越来越小
so far=ph. 到目前为止
so long as=ph. 如果,只要
somehow or other=ph. 设法,藉某种方法,不知道为什么
stand out against=ph. 某种事物衬托之下而显得突出
start for=ph. 前往某地,(同bound for)
stick to=ph. 忠于
take back=ph. 从此处拿走
take care of=ph. 照顾
take leave of=ph. 离开,告别
take place=ph. 发生,产生
take pride in=ph. 以…为荣
take revenge on=ph. (~ sb.)报仇
take sb. in=ph. 欺骗某人
take up=ph. 占据,耗费
talk…into=ph. 信服,劝服
ten to one=ph. 十之八九,非常可能地
to accomplish=ph. 实行,完成
to adhere to=ph. 依附,坚持,固守
to arrive at=ph. 到达
to ask for advice=ph. 请求忠告
to be about to=ph. 即将
to be all set to do=ph. (~ sth.)准备做某事
to be bound for somewhere=ph. 前往某地
to be bound to=ph. 必定,必然
to be cut out for=ph. 使…适合,有…的才能
to be deceived=ph. 受骗(被动)
to be designed for=ph. 使…适合,有…的才能
to be full of=ph. 充满
to be hard of hearing=ph. 重听
to be in charge of=ph. 管理,负责
to be in the way=ph. 妨碍,阻挠
to be mixed up=ph. 混淆,迷惑
to be obliged to=ph. 不得不
to be out of the question=ph. 不可能
to be outstanding=ph. 显著,杰出,突出
to be over=ph. 结束,完毕
to be prominent=ph. 显著,杰出,突出
to be taken in=ph. 受骗
to be tired out=ph. 非常疲倦
to be up to=ph. (~ sth.)计划,图谋,策划
to be up to date=ph. 最新式的
to be used to=ph. 习惯于…,对…习惯
to be well off=ph. 富有的,小康的
to bear in mind=ph. 记住,(同keep in mind)
to beat about the bush=ph. 旁敲侧击,拐弯抹角
to become of=ph. 发生
to believe in=ph. 信仰,深信
to blow out=ph. 爆裂,吹熄(蜡烛),烧断(保险丝)
to blow up=ph. 爆炸
to break down=ph. 抛锚
to break in=ph. 调整,适应 ,插嘴 , 闯入
to break off=ph. 终止,断绝
to break out=ph. 爆发,突然发生(可置于句首或句中)
to bring back=ph. 退还
to bring out=ph. 生产,出示
to bring to=ph. 使复苏,使苏醒
to bring up=ph. 抚养,养育,教养
to build up=ph. 增加,加强
to burn down=ph. 烧毁
to burn out=ph. 烧断
to burn up=ph. 烧光
to burst out crying=ph. 突然大哭
to burst out laughing=ph. 突然大笑
to call for=ph. 去取物,去找人
to call off=ph. 取消,宣告终止
to call on=ph. 拜访某人
to call sb. down=ph. 责骂某人
to call up=ph. 打电话
to carry out=ph. 实行,完成
to catch cold=ph. 感冒
to catch fire=ph. 着火
to catch on=ph. 理解,明白
to change one's mind=ph. 改变主意
to check on=ph. 检查,审查,调查
to check up=ph. 检查,审查,调查
to check up on=ph. 检查,审查,调查
to cheer up=ph. 使高兴,振作起来
to come about=ph. 发生,产生
to come across=ph. 偶然遇到,无意中发现
to come from=ph. 出生于,来自于
to come to=ph. 清醒,恢复知觉
to come to an end=ph. 结束
to come true=ph. 实现
to count on=ph. 依赖
to cross out=ph. 删除
to dissuade from=ph. 劝…不要…
to do one's best=ph.
to do sth. over=ph. 重做
to do without=ph. 免除,无需
to drop in on=ph. 偶访
to drop out=ph. 离去,不参加
to drop sb. a line=ph. 写封短信给…,留便条给…
to eat in=ph. 在家出饭
to eat out=ph. 到餐馆吃饭
to fall in love with=ph. (~ sb.)爱上某人
to fall off=ph. 落下,减少
to fall through=ph. 失败,不能实现
to feel like=ph. (~ Ving) 想要
to feel sorry for=ph. 同情
to figure out=ph. 算出,想出
to fill out=ph. 填写
to find fault with=ph. 挑剔
to find out=ph. 了解,发现
to fool around=ph. 嬉戏,虚度光阴,游手好闲,鬼混
to get alone with=ph. 相处融恰 ,进展顺利
to get along with=ph. 与…和好相处
to get away=ph. 逃去,离去,逃脱
to get back=ph. 回来
to get better=ph. 变好
to get busy=ph. 忙碌
to get even with=ph. 报复,报仇
to get in=ph. 上公交车(船,飞机)
to get in touch with=ph. 与…联络
to get lost=ph. 迷路,迷失
to get mixed up=ph. 混淆,迷惑
to get nervous=ph. 紧张
to get on=ph. 上公交车(船,飞机)
to get one's own way=ph. 一意孤行
to get out of=ph. 下车(船,飞机)
to get over=ph. 恢复,克复
to get rid of=ph. 摆脱
to get set=ph. 弄
to get sick=ph. 生病
to get through=ph. 结束,完成
to get tired=ph. 疲倦
to get tired of=ph. 对…感到厌倦
to get to a place=ph. 到达某处
to get up=ph. 起床
to get used to=ph. 逐渐习惯
to get well=ph. 康复
to get worse=ph. 变坏
to give birth to=ph. 生,生产
to give in=ph. 屈服,投降,退让
to give sb. a ring=ph. 打电话给某人
to give up=ph. 投降,放弃
to go around=ph. 够用,够分配
to go in for=ph. 爱好,嗜好,沉迷于
to go off=ph. 爆炸,离开
to go on=ph. 继续
to go out=ph. 离开,熄灭
to go wrong=ph. 出毛病,发生故障
to grow out of=ph. 戒除,因长大而不合用
to hand in=ph. 缴交
to hang up=ph. 悬挂,挂断
to have a good time=ph. 过得愉快
to have got to do=ph. (~ sth.)必须
to have it in for=ph. 憎恨,憎恶,伺机报复
to have it out with=ph. 与…起纠纷,和…摊牌,揭露真相
to have on=ph. 穿,戴(衣帽等)
to have one's heart set on=ph. 渴望,倾心于
to have one's own way=ph. 一意孤行
to have time off=ph. 有空
to have…on=ph. 穿着
to have…to do with=ph. 与…有关
to hear from=ph. 接到某人来信或消息
to hear of=ph. 有关…的消息
to hold out=ph. 继续供应,足以维持,力足抵抗
to hold up=ph. 持枪抢劫,耽搁
to hurry up=ph. 赶快
to improve=ph. 变好
to keep an eye on=ph. 留意
to keep away from=ph. 远离
to keep house=ph. 做家事
to keep in mind=ph. 记住
to keep in touch with=ph. 与…联络
to keep on=ph. 继续
to keep out=ph. 远离
to keep track of=ph. 追踪
to keep up=ph. 保持同一速度或水平
to knock out=ph. 击昏,击倒
to know sb. by sight=ph. 曾经见过,面熟
to lay off=ph. 暂时解雇,资遣
to leave sth. out=ph. 漏掉,删除
to let go of=ph. (~ sth.)释放某物
to let on=ph. 泄露,透露
to let sth. alone=ph. 听任,别管,避开
to let up=ph. 减弱,减少
to lie down=ph. 躺下
to live up to=ph. 遵从,达到
to look after=ph. 照顾
to look at=ph. 望着,注视
to look down upon=ph. 轻视,瞧不起,藐视
to look for=ph. 寻找,期盼
to look forward to=ph. 期待
to look into=ph. 调查
to look out=ph. 小心,注意
to look out upon=ph. 面对,俯视
to look over sth=ph. 检查
to look up=ph. 查出
to look up to=ph. 敬佩 ,尊敬
to make believe=ph. 假装
to make clear=ph. 解释说明
to make faces=ph. 扮鬼脸
to make friends=ph. 交朋友
to make fun of=ph. (~ sb./sth.) 嘲笑
to make good=ph. 成功
to make good time=ph. 以高速驾车旅行
to make no difference=ph. 没关系,没什么区别
to make out=ph. 做,成功,了解,准备,假装
to make over=ph. 更新,修改
to make sense=ph. 有意义,合理的
to make sure=ph. 确定,务必
to make the best of=ph. 逆来顺受
to make up one's mind=ph. 下决心,决意
to meet sb. half-way=ph. 妥协,让步,迁就
to mix up=ph. 混淆,迷惑
to one's disappointment=ph. 令人失望的是…
to one's heart's content=ph. 尽兴地,随心所欲地
to one's pleasure=ph. 令人高兴的是…
to one's relief=ph. 令人欣慰的是
to one's satisfaction=ph. 令人满意的是…
to one's surprise=ph. 令人满意的是…
to overturn=ph. 翻转,颠倒,移交
to pay attention to=ph. 注意
to pick out=ph. 挑选
to pick up=ph. 拾起,购员,搭载某人(搭便车)
to play jokes on=ph. 戏弄,开玩笑
to play tricks on=ph. 戏弄,开玩笑
to point out=ph. 指出
to put an end to=ph. 结束,终止
to put away=ph. 拿开,贮存
to put off=ph. 延迟,延续
to put on=ph. 穿,戴(衣帽等)
to put out=ph. 熄灭
to put sth. into practice=ph. 实行,完成
to put up=ph. 盖,建造
to put up with=ph. 容忍,忍受
to read over=ph. 匆匆越过,略为阅读
to remove=ph. 脱去(衣帽)
to run away=ph. 不告而别,逃走
to run errands=ph. 跑腿,跑差事
to run out of=ph. 用完
to run over=ph. 辗过
to see about=ph. 照顾
to sell out=ph. 售完 ,清理
to serve one right=ph. 罪有应得,接受应得的处罚
to set fire to=ph. (~ sth.)放火,焚烧
to set forth=ph. 动身,启程,提出
to set on fire=ph. 放火,焚烧
to set out=ph. 动身,起程
to shake hands=ph. 握手
to show off=ph. 买弄,炫耀
to show up=ph. 出现,露面
to shut off=ph. 关闭
to shut up=ph. 关闭,住嘴
to sit down=ph. 坐下
to slacken=ph. 减弱,减少
to stand a chance=ph. 有机会,有可能
to stand for=ph. 代表,象征 ,容忍
to stand out=ph. 显著,杰出,突出
to stay in=ph. 留在家里
to stay out=ph. 不在家
to stay up=ph. 迟睡,熬夜
to stick out=ph. 伸出
to stick sb.=ph. 欺骗
to stick to=ph. 依附,坚持,固守
to stick up=ph. 竖立
to stir up=ph. 惹起,引起,鼓励,激励
to stop…from=ph. 使…不能,阻止…使免于
to take a look at=ph. 看一看
to take a walk=ph. 散步
to take advantage of=ph. 利用,占(某人)便宜
to take after=ph. 与…相像
to take back=ph. 送回
to take care of=ph. 照顾 ,处理,应付 ,承担(费用)
to take exercise=ph. 做运动
to take hold of=ph. 抓住
to take off=ph. 脱去(衣帽)
to take one's time=ph. 不急,慢慢来
to take out=ph. 取出,拔出,约某人外出
to take over=ph. 接管,接收,接办
to take pains=ph. 费力,尽力,用心
to take part in=ph. 参与
to take pity on=ph. 怜恤
to take place=ph. 发生,举行
to take sb. for=ph. 误认,错认
to take sth. for granted=ph. 认为…为理所当然
to take sth. into account=ph. 考虑
to take sth. up with sb.=ph. 着手处理,咨商
to take turns=ph. 轮流
to take up=ph. 攻读
to take…by surprise=ph. 使…惊讶
to talk over=ph. 讨论,商量
to telephone=ph. 打电话
to tell apart=ph. 辨别,辨认
to tell one from the other=ph. 辨别,辨认
to the effect that=ph. 大意是说…
to think of=ph. 想念,作…看法,对…认为
to think over=ph. 考虑,思索
to throw away=ph. 抛弃
to tolerate=ph. 容忍
to transfer to another=ph. 翻转,颠倒,移交
to try on=ph. 试穿,试戴
to try out=ph. 试验,试用
to turn a deaf ear to=ph. 不愿听,对…充耳不闻
to turn around=ph. 转身
to turn down=ph. 减低速度,降低音量 / 亮度,拒绝
to turn off=ph. 关闭电源
to turn on=ph. 打开电源
to turn out=ph. 结果变成
to turn out to be=ph. 结果成为
to turn over=ph. 翻转,颠倒,移交
to wait for=ph. 等待
to wait on=ph. 侍候,招待
to wait up for=ph. 等候至深夜不睡
to wake up=ph. 醒来,唤醒
to watch out for=ph. 警戒,留意
to wear down=ph. 磨损,使疲倦虚弱
to wear out=ph. 磨损
to wear sb. out=ph. 精疲力竭
to wear sth. out=ph. 穿破
to work out=ph. 进展,设计,结果变成
turn against=ph. 反抗
turn in=ph. 缴交
turn into=ph. 变成
turn to=ph. 求助于,着手,开始 (工作) ,查阅
up to sb. to=ph. 由某人决定
upside down=ph. 倒置
used to=ph. 过去常常
what do you say to=ph. …如何
without fail=ph. 务必,一定地
work round the clock=ph. 迟睡,熬夜
would like to=ph. 想要
would rather=ph. 宁愿
