a=ad.一個
able=ad.有能力的
about=ad.大約
above=ad.在…之上
abuse=n.濫用,虐待
accept=v.接受
accident=n.意外
accuse=v.控告
across=ad.跨越
act=v.動作
activist=n.活動人士
actor=n.演員
add=v.加
administration=n.行政
admit=v.承認
adult=n.成人
advertise=v.廣告
advise=v.建議
affect=v.影響
afraid=ad.害怕
after=ad.在…之後
again=ad.再次
against=ad.對立
age=n.年齡
agency=n.社,局
aggression=n.攻擊,侵犯
ago=ad.…以前
agree=v.同意
agriculture=n.農業
aid=v.援助
aim=v.目標,瞄準
air=n.空氣
air force=n.空軍
airplane=n.飛機
airport=n.機場
album=n.專輯
alcohol=n.酒精
alive=ad.活著
all=ad.所有
ally=n.聯盟
almost=ad.幾乎
alone=ad.單獨
along=ad.沿著
already=ad.已經
also=ad.也
although=conj.雖然
always=ad.總是
ambassador=n.大使
amend=v.修改
ammunition=n.彈藥
among=ad.在…之中
amount=n.數量
anarchy=n.混亂,無秩序
ancestor=n.祖先
ancient=ad.古老的
and=conj.和
anger=n.憤怒
animal=n.動物
anniversary=n.紀念日
announce=v.宣布
another=ad.另一個
answer=n.答案
any=ad.任何
apologize=v.道歉
appeal=v.上訴,訴求
appear=v.出現
appoint=v.指派
approve=v.證實
archeology=n.考古學
area=n.領域,地區
argue=v.爭吵
arms=n.武器
army=n.陸軍
around=ad.大約
arrest=v.逮捕
arrive=v.抵達
art=n.藝術
artillery=n.大砲
as=conj.如同,當…
ash=n.灰燼
ask=v.詢問,要求
assist=v.幫助
astronaut=n.太空人
astronomy=n.天文學
asylum=n.政治庇護
at
atmosphere=n.大氣
attach=v.聯繫,連結
attack=n.攻擊
attempt=v.企圖
attend=v.參加
attention=n.專心
automobile=n.汽車
autumn=n.秋天
available=ad.可以用的
average=n.平均
avoid=v.避免
awake=ad.醒著
award=n.獎品
away=ad.遠離
baby=n.寶寶
back
bad
balance=v.平衡
ball=n.球
balloon=n.氣球
ballot=n.選票
ban=v.禁止
bank=n.銀行,河堤
bar=v.阻止
barrier=n.障礙物
base=n.基地,基於
battle=n.戰役
be
beat=v.打
beauty=n.美麗
because=prep.因為
become=v.變成
bed=n.床
before=prep.以前
begin=v.開始
behavior=n.行為
behind=ad.在…之後
believe=v.相信
belong=v.屬於
below=ad.在…之下
best=ad.最好的
betray=v.背叛
better=ad.更好
between=ad.在…中
big
bill=n.法案,支票
biology=n.生物學
bird
bite=v.咬
black
blame=v.怪罪
bleed=v.流血
blind=ad.盲的
block=v.阻擋
blood=n.血液
blow=v.吹
blue=ad.藍色
boat=n.船
body=n.身體
boil=v.沸騰
bomb=n.炸彈
bone=n.骨頭
book=n.書
border=n.界線
born=v.出生
borrow=v.借
both=ad.兩者都
bottle=n.瓶子
bottom=ad.底部
box=n.盒子
boy=n.男孩
boycott=v.聯合抵制
brain=n.大腦
brave=ad.勇敢的
bread=n.麵包
break=v.打破
breathe=v.呼吸
bridge=n.橋
brief=ad.簡短的
bright=ad.明亮的
bring=v.帶來
broadcast=v.廣播
brother
brown
budget=n.預算
build=v.建造
building=n.建築物
bullet=n.子彈
burn=v.燃燒
burst=v.爆開
bury=v.埋葬
bus=n.公車
business=n.生意,商業
busy=ad.忙碌
but=conj.但是
buy=v.買
by
cabinet=n.內閣
call=v.稱呼,打電話
calm=ad.冷靜
camera=n.相機
camp=n.營隊
campaign=n.競選活動
can
cancel=v.取消
cancer=n.癌症
candidate=n.候選人
capital=n.首都
capture=v.捕捉
car
care=v.關心
career=n.職業’
careful=ad.仔細的
carry=v.攜帶
case (court)=n.案例
case (medical)=n.病例
cat
catch=v.抓
cause=v.導致
ceasefire=n.停火
celebrate=v.慶祝
center=n.中心
century=n.世紀
ceremony=n.典禮
chairman=n.主席
champion=n.冠軍
chance=n.機會
change=v.改變
charge=v.控告
chase=v.追逐
cheat=v.欺騙
cheer=v.鼓舞
chemicals=n.化學物
chemistry=n.化學
chief=n.隊長
child
children
choose=v.選擇
circle=n.圈圈
citizen=n.公民
city=n.城市
civilian=ad.民事的
civil rights=n.公民權
claim=v.要求,聲稱
clash –衝突
class=n.班級
clean=v.打掃
clear=ad.清楚的
clergy=n.神職人員
climate=n.氣候
climb=v.攀爬
clock=n.時鐘
close=v.關閉
cloth
clothes
cloud=n.雲
coal=n.煤
coalition=n.聯盟,聯合政府
coast=n.海岸
coffee
cold
collapse=v.倒下
college=n.學院
colony=n.殖民地
color
combine=v.結合
come
command=v.命令
comment=v.評論
committee=n.委員會
common=ad.普遍的
communicate=v.溝通
community=n.社區
company=n.公司
compare=v.比較
compete=v.競爭
complete=ad.完整的
complex=ad.複雜的
compromise=n.妥協
computer
concern=n.擔心,關心
condemn=v.譴責
condition=n.情況
conference=n.會議
confirm=v.確認,證實
conflict=n.衝突
congratulate=v.恭喜
Congress=n.國會
connect=v.連結
conservative=n.保守的
consider=v.認為,考慮
constitution=n.憲法
contact=n.接觸
contain=v.包含
container=n.容器
continent=n.洲
continue=v.繼續
control=v.控制
convention=n.會議
cook=v.煮飯
cool
cooperate=v.合作
copy=v.影印
corn=n.玉米片
correct=ad.正確的
corruption=n.貪污,腐敗
cost=n.成本
cotton=n.棉花
count=v.數
country=n.國家
court=n.法院
cover=v.掩蓋,包覆
cow=n.母牛
crash=v.墜毀
create=v.創造
creature=n.生物
credit=n.信用
crew=n.成員
crime=n.犯罪
criminal=n.罪犯
crisis=n.危機
criticize=v.批評
crops=n.農作物
cross=v.跨越
crowd=n.群眾
crush=v.壓碎
cry=v.哭
culture=n.文化
cure=v.治療
curfew=n.宵禁
current=n.流動,目前的
custom=n.習俗
customs=n.關稅
cut=v.切
dam=n.水壩
damage=v.損害
dance
danger=n.危險
dark=ad.黑暗
date=n.日期
daughter=n.女兒
day
dead
deaf=ad.聾的
deal=v.處理
debate=v.辯論
debt=n.欠債
decide=v.決定
declare=v.發表,佈達
decrease=v.降低
deep
defeat=v.打敗
defend=v.保護
deficit=n.缺點
define=v.定義
degree=n.度數
delay=v.延宕
delegate=n.代表
demand=v.命令,強制要求
democracy=n.民主
demonstrate=v.示威抗議,示範
denounce=v.指責,指控
deny=v.否定
depend=v.依靠
deplore=v.深表遺憾,悲悼
deploy=v.佈署
depression=n.憂鬱
describe=v.描述
desert=n.沙漠
design=v.設計
desire=v.很想要
destroy=v.破壞
detail=n.細節
detain=v.扣押,拘留
develop=v.發展
device=n.裝置
dictator=n.獨裁者
die
diet=n.餐
different=ad.不同的
difficult=ad.困難的
dig=v.挖
dinner
diplomat –外交官
direct=v.指導
direction=n.方向
dirt=n.泥土
disappear=v.消失
disarm=v.解除武裝
disaster=n.災難
discover=v.發現
discrimination=n.歧視
discuss=v.討論
disease=n.疾病
dismiss=v.解散,免職
dispute=v.爭論
dissident=n.持不同政見者
distance=n.距離
dive=v.潛水
divide=v.劃分
do
doctor=n.醫生
document=n.文件
dog
dollar
donate=v.捐款
door
double=v.雙倍
down
dream=v.做夢
drink
drive
drop=v.掉落
drown=v.淹水
drug=n.藥物
dry
during=ad.在…期間
dust=n.灰塵
duty=n.職責
each
early
earn=v.賺錢
earth=n.地球
earthquake=n.地震
ease=v.減輕
east=n.東方
easy
eat
ecology=n.生態學
economy=n.經濟
edge=n.邊緣
education=n.教育
effect=n.影響,效用
effort=n.努力
egg
either
elect=v.選舉
electricity –電力
embassy=n.大使館
embryo=n.胚胎
emergency=n.緊急事故
emotion=n.情緒
employ=v.雇用
empty=ad.空的
end=v.結束
enemy=n.敵人
energy=n.能量
enforce=v.強迫
engine=n.引擎
engineer=n.工程師
enjoy=v.享受
enough=ad.足夠的
enter=v.進入
environment=n.環境
equal=ad.同等的
equipment=n.配備
escape=v.逃亡
especially=ad.特別是
establish=v.建立
estimate=v.估計
ethnic=ad.種族的
evaporate=v.蒸發
even=ad.甚至
event=n.事件
ever
every
evidence=n.證據
evil=ad.邪惡的
exact
examine=v.檢驗
example=n.例子
excellent=ad.卓越的
except=prep.除了
exchange=v.交換
excuse=v.藉口
execute=v.處死
exercise=n.運動
exile=v.驅逐…,出境,流亡
exist=v.存在
expand=v.擴大
expect=v.預期
expel=v.驅逐
experience=v.經驗
experiment=v.實驗
expert=n.專家
explain=v.解釋
explode=v.爆炸
explore=v.探索
export=v.出口
express=v.表達
extend=v.延伸
extra=ad.額外的
extraordinary=ad.不同凡響的
extreme=ad.極端的
extremist=n.極端主義者
face=n.臉,面對
fact=n.事實
factory=n.工廠
fail=v.失敗
fair=ad.公正
fall=v.跌倒,掉下
false=ad.錯誤的
family=n.家族
famous=ad.有名的
fan=n.粉絲
far=ad.遠的
farm=n.農場
fast
fat=n.胖的
father
favorite=ad.最喜愛的
fear=v.害怕
federal=ad.聯邦的
feed=v.餵食
feel=v.感覺
female=n.女性
fence=n.籬笆,圍牆
fertile=ad.肥沃的
few
field=n.田野
fierce=ad.憤怒,猛烈
fight=v.打架
fill=v.填滿
film=v.影片
final=ad.最後的
financial=ad.經濟上的
find=v.發現
fine=n.罰款,好的,精美的
finish=v.完成
fire=v.開火
fireworks=n.煙火
firm=ad.堅定的
first
fish
fit=v.合適
fix=v.修理
flag=n.旗子
flat=ad.平坦的
flee=v.逃離
float=v.漂浮
flood=v.做水災
floor=n.地板
flow=v.流動
flower
fluid=n.液體
fly
fog=n.霧
follow=v.跟隨
food=n.食物
fool=v.愚人
foot=n.腳
for
force=v.強迫
foreign=ad.外國的
forest=n.森林
forget=v.忘記
forgive=v.原諒
form=v.形成,形式
former=ad.前者
forward=ad.往前
free=v.釋放
freedom=n.自由
freeze=v.凍結
fresh=ad.新鮮
friend=n.朋友
frighten=v.使害怕
from
front=n.前端
fruit=n.水果
fuel=n.油料
full=ad.滿的
fun=n.樂趣
funeral=n.葬禮
future=n.未來
gain=v.增加
game=n.遊戲,比賽
gas=n.氣體
gather=v.蒐集
general=n.將軍,一般的
generation=n.世代
genocide=n.種族屠殺
gentle=ad.溫柔的
get
gift
girl
give
glass=n.玻璃
go
goal=n.目標
god=n.神
gold=n.金子
good
goods=n.貨品
govern=v.統治管理
government=n.政府
grain=n.榖物
grass=n.青草
gray
great
green
grind=v.磨碎
ground=n.地面
group=n.團體
grow=v.成長
guarantee=v.保證
guard=v.保護
guerrilla=n.游擊隊
guide=v.引導
guilty=ad.有罪的
gun=n.槍枝
hair
half=n.一半
halt=v.停止
hang=v.吊掛,上吊
happen=v.發生
happy
hard
harm=v.傷害
harvest=v.豐收
hat
hate=v.恨
have
he
head
headquarters=n.總部
heal=v.治療
health=n.健康
hear
heat=v.加熱
heavy=ad.重的
helicopter=n.直升機
help=v.幫助
here
hero=n.英雄
hide=v.隱藏
high
hijack=v.搶劫
hill=n.山丘
history=n.歷史
hit=v.打
hold=v.持著,保留
hole=n.洞
holiday=n.假日
holy=ad.神聖的
home
honest –誠實的
honor=v.榮耀
hope=v.希望
horrible=ad.可怕的
horse=n.馬
hospital=n.醫院
hostage=n.人質
hostile=ad.充滿敵意的
hot
hotel
hour=n.小時
house
how
however –然而
huge=ad.巨大的
human=ad.人類
humor=n.幽默
hunger=n.飢餓
hunt=v.狩獵
hurry=v.趕快
hurt
husband=n.丈夫
ice
idea=n.點子
identify=v.辨別,認出
if
ignore=v.忽視
illegal=ad.非法的
imagine=v.想像
immediate=ad.馬上的,立刻的
immigrant=n.移民
import=v.進口
important=ad.重要的
improve=v.改善
in
incident=n.事件
incite=v.鼓勵,煽動
include=v.包含
increase=v.增加
independent=ad.獨立的
individual=n.個別的人
industry=n.工業,行業
infect=v.感染
inflation=n.通貨膨脹
influence=v.影響
inform=v.通知
information=n.訊息
inject=v.注射
injure=v.傷害
innocent=ad.無罪的
insane=ad.精神不正常
insect=n.昆蟲
inspect=v.檢查
instead=ad.取代
instrument=n.儀器
insult=v.侮辱
intelligence=n.智力
intelligent=ad.聰明的
intense=ad.強烈的
interest=n.興趣,利息
interfere=v.干預
international=ad.國際的
Internet
intervene=v.介入
invade=v.入侵
invent=v.發明
invest=v.投資
investigate=v.調查
invite=v.邀請
involve=v.包含,涉入
iron=n.鐵
island=n.小島
issue=n.議題,發行
it
jail=n.監獄
jewel=n.珠寶
job=n.工作
join=v.參加
joint=ad.聯合的
joke
judge=v.評判
jump
jury=n.陪審團
just
justice=n.正義
keep=v.擁有,保持
kick=v.踢
kidnap=v.綁架
kill=v.殺
kind
kiss
knife=n.刀子
know=v.知道
knowledge=n.知識
labor=n.勞工
laboratory=n.實驗室
lack=v.缺乏
lake=n.湖泊
land=v.土地
language=n.語言
large=ad.大的
last=v.持續
late
laugh=v.笑
launch=v.啟動
law=n.法律
lead=v.引導
leak=v.漏洞,露出
learn=v.學習
leave=v.離開
left=ad.左邊的
legal=ad.法律的
legislature=n.立法機關
lend=v.借
less=ad.較少
let=v.讓
letter=n.信件
level=n.程度
liberal=ad.自由主義的
lie
life
lift=v.提升
light
lightning=n.閃電
like
limit=v.限制
line=n.線段
link=v.連結
liquid=n.液體
list=v.名單,名冊
listen=v.聽
literature=n.文學
little
live=v.居住
load=v.裝載
loan=n.貸款
local=ad.當地的
lonely=ad.寂寞的
long
look
lose=v.失去
loud=ad.大聲的
love
low=ad.低的
loyal=ad.忠誠的
luck=n.幸運
machine=n.機器
magazine=n.雜誌
mail=n.信件
main=ad.主要的
major=ad.主要的
majority=n.多數
make
male=n.男性的
man
manufacture=v.加工製造
many
map=n.地圖
march=v.遊行
mark=v.標示
market=n.市場
marry=v.嫁或娶
mass=n.大量
mate=v.交配
material=n.物質
mathematics=n.數學
matter=n.事情
may=v.可能
mayor=n.市長
meal=n.餐
mean=v.意思是…
measure=v.測量
meat=n.肉類
media=n.媒體
medicine=n.藥物
meet=v.遇到
melt=v.溶化
member=n.成員
memorial=n.紀念館/碑
memory=n.記憶
mental=ad.心智的
message=n.訊息
metal=n.金屬的
method=n.方法
microscope=n.顯微鏡
middle=n.中間
militant=n.好戰者
military=n.軍事的
militia=n.國民軍,民兵部隊
milk
mind=n.心智
mine=v.挖掘,採礦
mineral=n.礦物質
minister=n.大臣
minor=ad.少數的
minority=n.小眾,少數者
minute=n.分鐘
miss=v.錯過
missile=n.飛彈
missing=ad.遺失的
mistake=n.錯誤
mix=v.混合
mob=n.暴民
model=n.模範
moderate=ad.適宜的
modern=ad.現代的
money=n.錢
month=n.月份
moon
moral=ad.有關道德的
more
morning
most
mother
motion=n.行動
mountain
mourn=v.哀慟
move=v.移動
movement=n.移動
movie=n.電影
much
murder=v.謀殺
music
must
mystery=n.謎團
name
narrow=ad.狹窄的
nation=n.國家
native=n.土生土長的
natural=ad.自然的
nature=n.自然
navy=n.海軍
near=ad.附近
necessary=ad.必須的
need=v.需要
negotiate=v.交涉,協商
neighbor=n.鄰居
neither
neutral=ad.中立的
never=ad.從不
new
news
next
nice
night
no
noise=n.噪音
nominate=v.提名
noon
normal=n.正常的
north=n.北方
not
note=v.提醒,紙條
nothing
now
nowhere
nuclear=ad.核子的
number
obey=v.遵守
object=v.物體
observe=v.觀察,慶祝
occupy=v.佔據
ocean=n.海洋
of
off
offensive=n.攻擊的
offer=v.提供
office=n.辦公室,公職
officer=n.長官
official=n.官員
often=ad.經常
oil=n.油
old
on
once=ad.一次
only
open
operate=v.操作
opinion=n.意見
oppose=v.反對
opposite=ad.相反的
oppress=v.壓迫
or
orbit=v.天體軌道
order=v.命令
organize=v.組織
other
our
oust=v.驅逐
out
over
overthrow=v.推翻
owe=v.欠
own=v.擁有
pain=n.疼痛
paint=v.繪圖
paper
parachute=n.降落傘
parade=n.遊行
pardon=v.原諒
parent
parliament=n.議會,國會
part
partner=n.夥伴
party=n.派對,黨
pass=v.通過
passenger=n.乘客
passport=n.護照
past
path=n.小徑
patient=n.病人
pay=v.付錢
peace=n.和平
people=n.人們
percent=n.百分比
perfect=ad.完美的
perform=v.表演
period=n.期間
permanent=ad.永久的
permit=v.允許
person
persuade=v.說服
physical=ad.生理的
physics=n.物理學
picture
piece
pig
pilot=n.導航員,飛機駕駛
pipe=n.管子
place
plan=v.計畫
planet=n.星球
plant=v.種植,植物
plastic=n.塑膠的
play
please=v.取悅
plenty=n.很多
plot=v.策劃,陰謀
poem=n.詩
point=v.點
poison=n.毒藥
police=n.警方
policy=n.政策
politics=n.政治
pollute=v.污染
poor=n.窮的
popular=ad.受歡迎的
population=n.人口
port=n.港口
position=n.地點
possess=v.擁有
possible=ad.可能的
postpone=v.延後
pour=v.倒
poverty=n.貧窮
power
praise=v.稱讚
pray=v.祈禱
predict=v.預測
pregnant=ad.懷孕的
present=v.提出,禮物
president=n.總統,總裁
press=v.壓,新聞界
pressure=n.壓力
prevent=v.避免
price=n.價格
prison=n.監獄
private=ad.私人的
prize=n.獎品
probably=ad.或許
problem=n.問題
process=n.處理
produce=v.產生
profession=n.職業
professor=n.教授
profit=n.利潤
program=n.計畫
progress=n.進步
project=n.計畫
promise=v.承諾
propaganda=n.宣傳活動
property=n.財產
propose=v.提出
protect=v.保護
protest=v.抗議
prove=v.證實
provide=v.提供
public=ad.公開的
publication=n.出版物
publish=v.出版
pull=v.拉
pump=v.打氣
punish=v.處罰
purchase=v.購買
pure=ad.純的
purpose=n.目的
push=v.推
put=v.放置
quality=n.品質
question=v.問題
quick=ad.快速
quiet=ad.安靜的
race=v.賽跑
radar=n.雷達
radiation=n.輻射能
radio=n.收音機廣播
raid=v.襲擊,突然搜查
railroad=n.鐵路
rain=n.雨
raise=v.舉起,養育
rape=v.強暴
rare=ad.稀有的
rate=n.速率
reach=v.達到
react=v.反應
read=v.閱讀
ready=ad.準備好的
real=ad.真的
realistic=ad.現實的
reason=n.理由
reasonable=ad.合理的
rebel=v.反抗
receive=v.收到
recent=ad.最近的
recession=n.經濟衰退
recognize=v.認出,認清
record=v.記錄
recover=v.復原
red
reduce=v.減少
reform=v.改革
refugee=n.難民
refuse=v.拒絕
register=v.註冊
regret=n.後悔,悔恨
reject=v.拒絕
relations=n.關係,親戚
release=v.釋放,發行
religion=n.宗教
remain=v.保持,仍舊
remains=n.遺體
remember=v.記得
remove=v.移除
repair=n.修復
repeat=v.重複
report=v.報告
represent=v.代表,象徵
repress=v.壓制,約束
request=v.要求
require=v.需要
rescue=v.拯救
research=n.研究
resign=v.辭職
resist=v.抵抗
resolution=n.決心,會議的決議
resource=n.資源
respect=v.尊重
responsible=ad.負責任的
rest=v.休息
restaurant=n.餐廳
restrain=v.抑制,限制
restrict=v.限制
result=v.產生,導致,結果
retire=v.退休
return=v.回去,歸還
revolt=v.造反
rice=n.米
rich=ad.富有的
ride=v.搭乘,騎乘
right
riot=v.暴動
rise=v.上升
risk=n.危機,風險
river=n.河流
road=n.道路
rob=v.搶劫
rock=n.岩石
rocket=n.火箭
roll=v.滾動
room=n.房間
root=n.根部
rope=n.繩子
rough=ad.粗糙的
round=ad.圓形的
rub=v.摩擦
rubber=n.橡膠
ruin=v.破壞
rule=v.統治
run
rural=ad.鄉間的
sabotage=v.破壞
sacrifice=v.犧牲
sad=ad.悲傷的
safe=ad.安全的
sail=v.航海
sailor=n.水手
salt=n.鹽
same=ad.一樣的
sand=n.沙子
satellite=n.衛星
satisfy=v.使滿足
save=v.保存,拯救
say=v.說
school=n.學校
science=n.科學
sea=n.海
search=v.尋找
season=n.季節
seat=n.座位
second=ad.第二的
secret=n.秘密
security=n.保全,安全
see=v.看到,了解
seed=n.種子
seek(ing)=v.獲得,設法
seem=v.似乎
seize=v.逮捕,抓住,沒收
self
sell=v.賣
Senate=n.參議院
send=v.寄
sense=v.感覺,感官
sentence=v.宣判,判刑
separate=v.使分開
series=n.連續,系列
serious=ad.嚴重的
serve=v.服務
service=n.服務
set=v.設置
settle=v.解決,定居
several=ad.數個
severe=ad.嚴重的
sex=n.性
shake=v.搖
shape=v.成形,形狀
share=v.分享
sharp=ad.尖銳的
she
sheep=n.綿羊
shell=v.砲轟,貝殼,軀殼,彈殼
shelter=v.保護,庇護
shine=v.發亮
ship=v.船
shock=v.震驚
shoe=n.鞋子
shoot=v.射擊
short
should=v.應該
shout=v.喊叫
show=v.展示
shrink=v.縮小
sick=ad.生病的
sickness=n.生病
side=n.邊
sign=v.簽名,符號
signal=v.打信號
silence=v.使安靜
silver=n.銀
similar=ad.相似的
simple=ad.簡單的
since=prep.自從
sing=v.唱歌
single=ad.單一的
sink=v.沉下去
sister
sit
situation=n.情況
size=n.尺寸
skeleton=n.骨骼
skill=n.技術
skin=n.皮膚
sky=n.天空
slave=n.奴隸
sleep=v.睡覺
slide=v.滑動
slow=v.減緩速度
small=ad.小的
smash=v.粉碎,打破
smell=v.聞起來
smoke
smooth=ad.平緩的,光滑的
snow=n.雪
so=ad.所以
social=ad.社會的
soft=ad.軟的
soil=n.土壤
soldier=n.士兵
solid=ad.固體的,強壯的
solve=v.解決
some=ad.一些
son=n.兒子
soon=ad.很快
sort=n.種類
sound=n.聲音
south=n.南方
space=n.空間,太空
speak=v.說
special=ad.特殊的
speech=n.演說
speed=v.速度,加速
spend=v.花費
spill=v.溢出
spirit=n.精神
split=v.分開,切開
sport=n.運動
spread=v.散佈
spring=n.春天
spy=v.間諜
square=n.正方形
stab=v.刺
stand=v.站立,忍受
star
start=v.開始
starve=v.挨餓
state=v.陳述,州
station=n.(公車、火車)站
statue=n.雕像
stay=v.停留
steal=v.偷竊
steam=n.蒸氣
steel=n.鋼鐵
step=v.腳步,踩
stick=v.棍子,黏著
still=ad.仍然
stone=n.石頭
stop=v.停止
store=v.保存,商店
storm=n.風暴
story=n.故事
stove=n.爐子
straight=ad.直的
strange=ad.奇怪的
street=n.街道
stretch=v.延伸
strike=v.敲打,罷工
strong=ad.強壯的
structure=n.結構
struggle=v.努力
study
stupid=ad.笨蛋的
subject=n.主題
submarine=n.潛水艇
substance=n.物質
substitute=v.代替
subversion=n.顛覆,覆滅
succeed=v.成功
such=ad.如此的
sudden=ad.突然
suffer=v.受苦,遭受
sugar=n.糖
suggest=v.建議
suicide=n.自殺
summer=n.夏天
sun
supervise=v.監督
supply=v.供給
support=v.支持
suppose=v.想,認為
suppress=v.封鎖,鎮壓
sure=ad.確定的
surface=n.表面
surplus=n.剩餘,過剩
surprise=v.驚喜
surrender=v.投降
surround=v.包圍
survive=v.活了下來
suspect=v.嫌犯,猜測
suspend=v.暫停,中止
swallow=v.吞嚥
swear in=v.宣誓就職
sweet=ad.甜的
swim=v.游泳
sympathy=n.同情,憐憫
system=n.系統
take
talk
tall
tank=n.坦克車,油槽,水箱
target=n.目標
taste=v.品嚐
tax=n.稅金
tea
teach
team=n.隊伍
tear=v.撕毀
technical=ad.技術的
technology=n.科技
telephone
telescope=n.望遠鏡
television
tell
temperature=n.溫度
temporary=ad.暫時的
tense=ad.緊張的
term=n.期間,任期,學期,條件
terrible=ad.可怕嚇人的,討厭的
territory=n.領土,版圖
terror=n.恐懼
terrorist=n.恐怖份子
test=v.測試
than
thank
that
the
theater=n.戲院
them
then=ad.那時
theory=n.理論
there=ad.那裡
these=pro.這些
they
thick=ad.厚的
thin=ad.薄的
thing=n.東西
think=v.想
third
this
threaten=v.威脅
through=prep.通過
throw=v.丟擲
tie=v.綁
time
tired=ad.疲倦
to
today
together=ad.一起
tomorrow
tonight
too
tool=n.工具
top=n.頂端
torture=v.折磨
total=n.總共
touch=v.碰觸
toward
town=n.城鎮
trade=v.交易
tradition=n.傳統
traffic=n.交通
tragic=ad.悲慘的
train=v.訓練,火車
transport=v.運輸
transportation=n.運輸
trap=v.陷阱,設下圈套
travel=v.旅遊
treason=n.叛國
treasure=n.寶藏
treat=v.對待,治療
treatment=n.治療,對待
treaty=n.條約,協定
tree
trial=n.審判
tribe=n.部落
trick=v.欺騙,愚弄
trip=n.旅行
troops=n.軍團
trouble=n.麻煩
truce=n.停戰,休戰
truck=n.貨車
true
trust=v.相信
try=v.嘗試
tube=n.管狀物,電視機
turn=v.轉
under
understand=v.了解
unite=v.結合,團結
universe=n.宇宙
university=n.大學
unless=conj.除非
until=conj.直到…為止
up
urge=v.慫恿,敦促
urgent=ad.緊急的
us
use=v.使用
usual=ad.平常的,普通的
vacation=n.假期
vaccine=n.疫苗
valley=n.山谷
value=n.加值
vegetable=n.蔬菜
vehicle=n.車輛
version=n.版本
very
veto=v.否決
victim=n.受難者
victory=n.勝利
video
village=n.村落
violate=v.違反
violence=n.暴力
visa=n.簽證
visit=v.拜訪
voice=n.聲音
volcano=n.火山
volunteer=n.自願者,志工
vote=v.投票
wages=n.工資
wait=v.等待
walk=v.走路
wall=n.牆壁
want=v.想要
war=n.戰爭
warm=ad.溫暖的
warn=v.警告
wash=v.洗
waste=v.浪費
watch=v.觀賞,手錶
water
wave=v.波浪,揮動
way=n.方式
we
weak=ad.虛弱的
wealth=n.財富
weapon=n.武器
wear=v.穿
weather=n.天氣
Web site
week=n.星期
weigh=v.量重量
welcome=v.歡迎
well=ad.很好,井
west=n.西方
wet=ad.潮溼的
what
wheat=n.小麥
wheel=n.輪子
when=ad.何時
where
whether
which
while=n.當
white
who
whole=ad.全部
why
wide=ad.寬的
wife=n.老婆
wild=ad.狂野的,野生的
will
willing=ad.有意願的
win=v.贏
wind=n.風
window=n.窗戶
winter=n.冬天
wire=n.電線
wise=ad.有智慧的
wish=v.希望
with
withdraw=v.退出,撤退
without
witness=n.證人,目睹
woman
wonder=v.懷疑
wonderful=ad.美好的
wood=n.木頭
word
work
world=n.世界
worry=v.擔心
worse=ad.更壞的
worth=n.價值
wound=v.傷害,傷口
wreck=v.破壞
wreckage=n.殘骸
write=v.寫字
wrong=ad.錯的
year=n.年
yellow
yes
yesterday
yet=ad.還沒
you
young=ad.年輕的
zero
zoo=n.動物園
