TV machine=電視機
security grille=安全護網
remote control=遙控器
180 degree rotation=180度旋轉
instructions=說明書
360 degree rotation=360度旋轉
guarantee=保證書
timing=定時
warranty period=保證期限
air conditioner=冷氣機
operating instructions=操作說明
independent=獨立式
using method=使用方法
separate=分離式
function=功能
window-type air conditioners=窗型冷氣
channel=頻道
volume=音量
power saving=省電
size=尺寸
mute=靜音
color=彩色
antibacterial=抗菌
monochrome=黑白
sleep device=睡眠裝置
light=明亮
microcomputer temperature control=微電腦控溫
image=影像
phone=電話機
picture=畫質
wireless phone=無線電話
plug=插頭
corded phones=有線電話
socket=插座
caller id=來電顯示功能
wire=電線
answering machine=答錄機
voltage=電壓
extension=分機
volt=伏特
battery=電池
redial=重撥
switch=開關
speed ​​dial=速撥
push button=按鈕
reservation=保留
turn on=打開
wait=等待
turn off=關掉
transfer=轉接
adjustment=調整
inside=內線
choose=選擇
busy=占線
press=按
charging=充電
VCR=錄放影機
memory number=記憶號碼
videotape=錄影帶
electric light=電燈
CD-ROM drive=光碟機
fluorescent lamp=日光燈
pre-recorded=預錄
table lamp=檯燈
timer switch=定時開關
chandelier=吊燈
rewind=倒帶
lamp shade=燈罩
fast forward=快轉
light bulb=燈泡
play=播放
wattage=瓦數
length=長度
washing machine=洗衣機
fault=故障
dryer=脫水機,烘乾機
audio=音響
bedside audio=床頭音響
stainless steel=不銹鋼
walkman=隨身聽
wash=洗淨
CD walkman=CD隨身聽
dehydration=脫水
radio=收音機
capacity=容量
motor=馬達
audio tape=錄音帶
water heater=熱水器
speaker=喇叭
electric water heaters=電熱水器
sound effects=音效
gas water heater=燃氣熱水器
headphone=耳機
magnetic head=磁頭
smoke machine=排油煙機
microphone=麥克風
oil filter=濾油網
refrigerator=電冰箱
gas stove=燃氣爐
single door=單門
gas=燃氣
double doors=雙門
microwave=微波爐
frozen=冷凍
oven=烤箱
refrigeration=冷藏
toaster=烤麵包機
temperature=溫度
rice cooker=飯鍋
5 degrees celsius=攝氏5度
electric cooker=電子鍋
minus 1 degree=零下1度
stew pot roast=燜燒鍋
ice box=制冰盒
juicer=果汁機,榨汁機
crisper=保鮮盒
set egg rack=置蛋架
egg beater=打蛋機
fruit and vegetable box=果菜箱
coffee pot=咖啡壺
drink holder=飲料架
thermos=熱水瓶
deodorizing device=除臭裝置
dispenser=飲水機
ice retreat=退冰
raw water=生水
ice=冰塊
boiling water=開水
frost=霜
boiling point=沸點
refrigerant=冷媒
dehumidifiers=除濕機
leak=漏水
humidifier=加濕機
electric fans=電風扇
air cleaner=空氣清潔機
stand fan=立扇
heater=暖爐
ceiling fan=吊扇
hair dryer=吹風機
wind velocity=風速
automatic tailor machine=自動裁縫機
strong=強
vacuum cleaner=吸塵器
middle=中
camera=照相機
weak=弱
video camera=攝影機
