good=adj.好的
bad=adj.坏的
small=adj.小的
big=adj.大的
hugry=adj.饿的
full=adj.饱的
little=adj.少的
high=adj.高的
short=adj.矮的,短的
tall=adj.高的
long=adj.长的
old=adj.老的,旧的
new=adj.新的
young=adj.年轻的
many=adj.许多的
much=adj.许多的
beautiful=adj.漂亮的
nice=adj.美好的
early=adj.早的
late=adj.迟的
right=adj.正确的
wrong=adj.错误的
busy=adj.忙的
free=adj.空闲的
lazy=adj.懒的
bored=adj.无聊的
heavy=adj.重的
light=adj.轻的
blind=adj.盲的
special=adj.特别的
kind=adj.善良的
happy=adj.高兴的
sad=adj.伤心的
fast=adj.快的
fun=adj.有趣的
scary=adj.吓人的
different=adj.不同的
same=adj.同样的
round=adj.圆的
great=adj.伟大的
black=adj.黑的
white=adj.白的
blue=adj.蓝的
purple=adj.紫的
pink=adj.粉的
yellow=adj.黄的
orange=adj.桔黄的
green=adj.绿的
brown=adj.棕色的
grey=adj.灰的
gold=adj.金色的
sunny=adj.晴朗的
windy=adj.多风的
cloudy=adj.多云的
rainy=adj.多雨的
snowy=adj.多雪的
able=adj.有才干的,能干的
active=adj.主动的,活跃的;(反义词torpidity)
adaptable=adj.适应性强的;(反义词inadaptable)
adroit=adj.灵巧的,机敏的;(反义词clumsy)
aggressive=adj.有进取心的;(反义词ingressive)
alert=adj.机灵的
ambitious=adj.有雄心壮志的
amiable=adj.和蔼可亲的
amicable=adj.友好的
analytical=adj.善于分析的
apprehensive=adj.有理解力的
aspiring=adj.有志气的,有抱负的
audacious=adj.大胆的,有冒险精神的
capable=adj.有能力的,有才能的
careful=adj.办事仔细的;(反义词careless)
candid=adj.正直的;(反义词unjust)
charitable=adj.宽厚的
competent=adj.能胜任的
confident=adj.有信心的;(反义词diffident)
conscientious=adj.认真的,自觉的
considerate=adj.体贴的
constructive=adj.建设性的
contemplative=adj.好沉思的
cooperative=adj.有合作精神的
creative=adj.富创造力的
cute=adj.可爱的
dashing=adj.有一股子冲劲的,有拼搏精神的
dedicated=adj.有奉献精神的
devoted=adj.有献身精神的
dependable=adj.可靠的
diplomatic=adj.老练的,有策略的
disciplined=adj.守纪律的
discreet=adj.谨慎的(在行动,说话等方面)
dutiful=adj.尽职的
dynamic=adj.精悍的
earnest=adj.认真的
well-educated=adj.受过良好教育的
efficient=adj.有效率的
energetic=adj.精力充沛的
enthusiastic=adj.充满热情的
expressive=adj.善于表达
faithful=adj.守信的,忠诚的
forceful=adj.坚强的(性格)
frank=adj.直率的,真诚的
friendly=adj.友好的
frugal=adj.俭朴的
good=adj.好的
generous=adj.宽宏大量的
genteel=adj.有教养的
gentle=adj.有礼貌的
handsome=adj.英俊的
hard working=adj.勤劳的,勤奋的
have an inquiring mind=adj.爱动脑筋
hearty=adj.精神饱满的
honest=adj.诚实的
hospitable=adj.殷勤的
humble=adj.恭顺的
humorous=adj.幽默的
impartial=adj.公正的
independent=adj.有主见的
industrious=adj.勤奋的
ingenious=adj.有独创性的
initiative=adj.首创精神
intellective=adj.有智力的
intelligent=adj.理解力强的
inventive=adj.有发明才能的,有创造力的
just=adj.正直的
kind-hearted=adj.好心的
knowledgeable=adj.有见识的
learned=adj.精通某门学问的
liberal=adj.心胸宽大的
logical=adj.条理分明的
loyal=adj.忠心耿耿的
methodical=adj.有方法的
modest=adj.谦虚的
motivated=adj.目的明确的
negative=adj.消极的
objective=adj.客观的
open-minded=adj.虚心的
orderly=adj.守纪律的
original=adj.有独创性的
painstaking=adj.辛勤的,苦干的,刻苦的
practical=adj.实际的
precise=adj.一丝不苟的
persevering=adj.不屈不挠的
positive=adj.积极的
punctual=adj.严守时刻的
purposeful=adj.意志坚强的
qualified=adj.合格的
rational=adj.有理性的
realistic=adj.实事求是的
reasonable=adj.讲道理的
reliable=adj.可信赖的
responsible=adj.负责的
self-conscious=adj.自觉的
selfish=adj.自私的
selfless=adj.无私的
sensible=adj.明白事理的
sincere=adj.真诚的
smart=adj.精明的
spirited=adj.生气勃勃的
sporting=adj.光明正大的
steady=adj.塌实的
straightforward=adj.老实的
strict=adj.严格的
stupid=adj.愚蠢的
ugly=adj.丑陋的
