stroke=v.撫摸,擊、打,一筆
stroll=v.漫步,閒逛
strut=v.趾高氣而地走,支柱
stubborn=adj.固執的,難以改變的
studied=adj.慎重的,認真習得的
stuffy=adj.(空氣)不新鮮的,(空氣等)悶人的
stultify=v.使變的荒謬可笑,使無用
stunning=adj.極富魅力的
stunt=v.阻礙,特技,絕技
stupor=.昏迷,不醒人事
sturdy=adj.(身體)強健的,結實的
stutter=n.v.結巴,口吃
stygian=adj.陰暗的,陰森森的
stylus=n.鐵筆
stymie=v.妨礙,阻撓
subdue=v.征服,壓制,減輕
subdued=adj.柔和的,緩和的
subject=n.受支配的人
subjective=adj.主觀的,想像的
subjugate=v.征服,鎮壓
sublime=adj.崇高的
subliminal=adj.淺意識的
submission=n.從屬,服從
submit=v.屈服,提交,呈遞
suborn=v.收買,賄賂
subpoena=n.v.傳票,傳訊
subsequent=adj.隨後的,後來的
subside=v.(建築物等)下陷,(天氣等)平息
subsidiary=adj.輔助的,次要的
subsidy=n.輔助金
subsistence=n.生存,生計,存在
substance=n.大意,根據,實質,物質
substantial=adj.堅固的,結實的,實質的
substantiate=v.證實,確認
substantive=adj.根本的,獨立存在的
substitute=n.代替品
subsume=v.包含,包容
subterfuge=n.詭計,託辭
subterranean=adj.地下的
subtle=adj.微妙的,精巧的
subtract=v.減去,減掉
subversive=adj.顛覆性的,破壞性的
subvert=v.顛覆,推翻
succinct=adj.簡明的,簡潔的
succor=v.n.救助,緩助
succumb=v.屈從,因…死亡
suffice=v.足夠,(食物)滿足
sufficient=adj.足夠的
suffocate=v.(使)窒息而死
suffrage=n.選舉權,投票權
suffragist=n.參政權擴大論者,婦女政權論者
suffuse=v.(色彩等)瀰漫,染遍
suitcase=n.手提箱,箱子
sulky=adj.生氣的
sullen=adj.憂鬱的
sultry=adj.悶熱的,(人)風騷的
summarily=adj.概括的,倉促地
summary=n.摘要,概要,摘要的,簡略的
summation=n.總結,概要,總數,合計
summon=v.召見,召集
sumptuous=adj.豪華的,奢侈的
sunder=v.分裂,分離
superb=adj.上乘的,出色的
supercilious=adj.目中無人的
superficial=adj.表面的
superficiality=n.淺薄
superfluity=n.多餘的量
superfluous=adj.多餘的,累贅的
superimpose=v.加在上面
superintend=v.監督
superiority=n.優越(感)
supernova=n.超新星
supersede=v.淘汰,取代
supervise=v.監督,管理
supine=adj.仰臥的,懶散的
supplant=v.排擠,取代
supple=adj.伸屈自如的,適應力強的
supplement=n.增補,補充
suppliant=adj.懇求的,哀求的,懇求者
supplicant=n.乞求者,懇求者
supplicate=v.懇求,乞求
supremacy=n.至高無上的,霸權
supreme=adj.至高的,極度的
surcharge=v.對…收取額外費用
surfeit=n.(食物)過量,過度
surge=v.波濤洶湧,波動
surgeon=n.外科醫師,軍醫,船上的醫生
surly=adj.脾氣暴躁的,陰沉的
surmise=n.v.推測,猜測
surmount=v.克服,戰勝
surpass=v.超過
surplus=adj.過剩的,盈餘的
surrealism=n.超現實主義
surrender=v.投降,放棄,歸還
surreptitious=adj.鬼鬼祟祟的
surrogate=n.代替品,代理人
surveyor=n.測量員
survive=v.倖存
susceptibility=n.易感性
susceptible=adj.易受影響的,脆弱的
suspect=v.懷疑,嫌疑犯,可疑的
suspend=v.暫緩,中止
suspense=n.懸念
suspicion=n.懷疑,覺察,嫌疑
suspicious=adj.懷疑的
sustain=v.承受(困難),支撐(重量)
sustained=adj.持久的,經久不衰的
sustenance=n.食物,糧食,生計
suture=n.v.(傷口的)縫線,縫合
svelte=adj.(女人)體態苗條的
swagger=v.大搖大擺地走
swallow=v.吞下,嚥下,忍受
swamp=n.沼澤,使陷入,淹沒
sway=v.搖動,搖擺,影響使改變
swell=v.腫脹,增強
sweltering=adj.酷熱的
swerve=v.突然改變方向
swift=adj.迅速的,敏捷的
swill=v.沖洗,痛飲
swindle=v.詐騙
swine=n.豬
swing=v.n.搖擺,旋轉,鞦韆
swirl=v.n.旋轉,漩渦
sybarite=n.奢侈逸樂的人
sybaritic=adj.放縱的,奢侈享樂的
sycophant=n.馬屁精
syllabus=n.教學綱要
symbiosis=n.共生(關係)
symmetry=n.對稱,均衡
symphony=n.交響樂,交響曲
synchronous=adj.同時發生的
syndrome=n.綜合症狀
synergic=adj.協同作用的,協力的
synopsis=n.摘要,概要
synoptic=adj.摘要的
synthesis=n.綜合,合成
syringe=n.注射器
table=v.擱置,不如考慮
taboo=adj.諱忌的,禁忌
tacit=adj.心照不宣的
taciturn=adj.沉默寡言的
tackiness=n.膠黏性
tackle=v.處理,滑車
