animadvert=v.苛責,非難
arrant=adj.完全的,徹底的,極壞的,臭名昭著的
assoil=v.赦免,釋放,補償,贖
befoul=v.弄髒,污衊中傷
besot=v.使沉醉,使糊塗
bide=v.等待,逗留
blather=v.胡說八道
bleary=adj.視線模糊的,朦朧的,精疲力竭的
bonny=adj.健美的,漂亮的
bouncing=adj.精力充沛的,健康的,活潑的
brew=v.釀酒,招致,醞釀,即將來臨
buffet=v.用手打,連續打擊,搏鬥
bulldoze=v.用推土機推平,威脅,恐嚇
bullish=adj.股票行情看漲的,樂觀的,自信的
bullyrag=v.恐嚇,威脅
bustle=v.奔忙,忙碌,喧鬧,熙熙攘攘
canorous=adj.音調優美的,響亮的
chaffing=adj.玩笑的,嘲弄的
champ=v.咀嚼
cheeky=adj.無禮的,厚顏無恥的
chipper=adj.充滿活力的,愉快的
chubby=adj.豐滿的,圓滾滾的
chuck=v.扔或拋,拋棄,解僱,辭職
clamber=v.爬上,攀登
clammy=adj.冷而粘濕的
con=n.反對,欺騙
countrified=adj.土氣的,粗俗的
crackpot=n.狂想者,癲狂的人
crib=v.抄襲,剽竊
crimp=v.壓褶,使捲曲,阻礙,束縛
cull=v.挑選,精選,挑剩下的次品
dash=v.破壞,使受挫,使羞愧
deluxe=adj.豪華的,華麗的
desist=v.停止
dicker=v.討價還價
dillydally=v.磨蹭,浪費時間
dither=n.v.慌張,猶豫不決
divers=adj.多樣的,各種各樣的
dowse=v.探尋水源或礦藏
draggy=adj.單調而無生氣的
drawn=adj.憔悴的
drip=v.滴下
drool=v.流口水,胡說
drub=v.重擊,嚴責,徹底擊敗
edgy=adj.急躁的,易激動的,鋒利的
elysian=adj.樂土的,像天空的,幸福的
encomiastic=adj.頌讚的,阿諛的
epideictic=adj.誇耀的
fancied=adj.空想的,虛構的
fatidic=adj.預言的
finagle=v.騙取,騙得
flatulent=adj.自負的,浮誇的
flighty=adj.輕浮的,反复無常的
flimflam=n.欺騙,胡言亂語
flossy=adj.華麗的,時髦的,絲綿的,柔軟的
flummox=v.使混亂,背誦出錯,失敗
folksy=adj.有民間風味的,親切的,友好的
freestanding=adj.獨立的,不依靠支撐物的
frumpy=adj.邋遢的,老式的,過時的
fuddle=v.灌醉,使迷糊
funky=adj.有黴臭味的
gabby=adj.饒舌的
gawky=adj.遲鈍的,笨拙的
goof=v.犯錯誤,消磨時間
gracile=adj.細弱的,纖細優美的
gravitate=v.被強烈地吸引
hanker=v.渴望,追求
hazy=adj.朦朧的,不清楚的
heady=adj.任性的,魯莽的
huffish=adj.不高興的,傲慢的
huffy=adj.憤怒的,怨恨的
hunker=v.蹲下,頑固地堅持
hurtle=v.急飛
interlard=v.使混雜,混入,點綴
jab=v.猛刺
josh=v.戲弄,戲耍
jostle=v.推擠,擠開通路
jounce=v.顛簸地移動
jumpy=adj.緊張不安的,心驚肉跳的
lard=v.使豐富,使充滿
leach=v.過濾
lymphatic=adj.無力的,遲緩的
matte=adj.無光澤的
maunder=v.胡扯,遊蕩
mealy=adj.粉狀的,膚色不健康的,蒼白的
muck=n.堆肥,淤泥,施肥,搗亂
mull=v.思考,思索,混亂
munch=v.出聲咀嚼
musky=adj.麝香的
nifty=adj.漂亮的,妙的
nippy=adj.寒冷刺骨的,刺鼻的
obsessive=adj.強迫性的,分神的
oleaginous=adj.油膩的,圓滑的,滿口恭維的
ornery=adj.頑固的,愛爭吵的
pavid=adj.害怕的,膽小的
peachy=adj.極好的,漂亮的
peckish=adj.餓的,急躁的
pelagic=adj.遠洋的,海水的
pendulous=adj.下垂的
perk=v.恢復,振作,打扮,豎起
picayunish=adj.微不足道的,不值錢的
piteous=adj.可憐的
pop=v.發出砰的一聲,突然出現
pound=v.強烈打擊,心砰砰跳,費力地移動
prong=v.刺,戳,貫穿
pudgy=adj.短而胖的,胖嘟嘟的
pushy=adj.過於積極的,冒進的
putter=.n.閒蕩,置放者
quasi=adj.貌似的,類似的,準的
quicksilver=adj.水銀的,易變的,塗上水銀
quondam=adj.原來的,以前的
rack=v.使痛苦,使受折磨
ramp=v.n.穩定增長或下降,坡道,斜坡
raptorial=adj.食肉的,兇猛的
ravening=adj.狼吞虎咽的
recusant=adj.n.不服從規章的
retch=v.作嘔,噁心
ritzy=adj.時髦的,勢利的
sag=v.鬆弛,下垂
sanitize=v.使…清潔
satiny=adj.光滑的,柔細的
saucy=adj.無禮的,調皮的,漂亮的
scamp=v.n.草率地做,惡棍,流氓
scraggly=adj.參差不齊的,蓬亂的
scruffy=adj.骯髒的,不潔的
shamble=v.蹣跚而行,踉蹌而行
shilly-shally=v.猶豫不決,虛度時光
simonize=v.給…上蠟,把…擦亮
slog=v.猛擊,苦幹
slosh=v.濺,潑,雪泥
slug=v.猛擊,拳擊
smite=v.重打,猛擊,折磨
smut=n.污跡,弄髒,污
snipe=v.狙擊
snivel=v.流鼻涕,啜泣
snooze=v.打盹兒,打瞌睡
soigne=adj.時髦的,優雅的
soulful=adj.充滿熱情的,深情的
sour=adj.酸的
spatter=v.噴灑
spew=v.嘔吐,大量噴出
sportive=adj.嬉戲的,歡鬧的
squab=adj.剛孵出的,羽毛未豐的
squirt=v.噴,射
stampede=v.驚跑,逃竄
stately=adj.莊嚴的,宏偉的
staunch=adj.堅定的,忠誠的
sticky=adj.濕熱的,悶熱的
straiten=v.使陷入困難,使變窄
stricken=adj.被折磨的,被擊中的
swathe=v.包,綁,裹
swig=v.痛飲
swoop=v.猛撲,突然襲擊
tatter=v.n.撕碎,碎片
tattle=v.閒聊;洩漏秘密
thump=v.重擊,捶擊
tony=adj.高貴的,豪華的
troll=v.釣魚,興高采烈地唱
trounce=v.痛擊,徹底地打敗
tumble=v.突然跌倒,突然下跌,倒塌
tweak=v.扭,擰,揪,調節,微調
unbosom=v.傾訴,吐露心事
velvety=adj.柔軟光滑的,爽口的
verboten=adj.被禁止的,嚴禁的
versant=adj.專心從事的,傾斜
vest=v.授權,授予,賦予
vintage=adj.經典的,最好的
wacky=adj.古怪的,愚蠢的
wend=v.行,走
wheeze=v.喘息,發出呼哧呼哧的聲音
whimper=v.哭哭啼啼,抽泣
wigwag=v.搖動,搖擺
wile=n.詭計,花言巧語
wispy=adj.纖細的,脆弱的
wroth=adj.激怒的,非常憤怒的
yank=v.拽,拔,猛拔
yen=v.上癮,渴望
yowl=v.嚎叫,慟哭
yummy=adj.美味的,可口的
zany=adj.n.荒唐可笑的,像小丑的,小丑,丑角
zoom=v.急速上升
