hypnotic=催眠的,催眠藥,安眠藥
hypocrite=偽善者,偽善者
hypocritical=虛偽的
hypotenuse=斜邊
hypothesis=假設,假說
hypothetical=假設的
hysteria=歇斯底里症,過度興奮
icicle=冰柱,冰垂
icon=聖像,偶像
iconoclast=攻擊傳統念或風俗的人
ideology=思想體系,思想意識,意識形態
idiom=習語,語言的習慣用法,特色
idle=無所事事的,無效的,懶散
idolater=神像,偶像崇拜者
idyll=田園生活,田園詩
igneous=火的,火絨的
ignite=發光,點燃,燃燒
ignoble=卑鄙的
ignominious=可恥的,屈辱的
ignominy=羞恥,屈辱
ignorant=無知的,愚昧的
illegal=違法的
illegitimate=不合法的,私生的
illicit=違法的
illiterate=文盲的
illuminate=闡明,解釋,照亮
illuminati=先覺者,智者
illusion=假象,錯覺
illusive=迷惑人的,迷幻的
illusory=虛幻的
illustrate=為…作插圖或圖表
imbibe=飲,吸入
imbroglio=糾紛,糾葛
imbue=灌輸強烈的情感或意見
imitation=贗品,效法,冒充
imitative=模仿的
immaculate=潔淨的,無瑕的
immanent=內在的,普遍存在的
immemorial=太古的,極鼓的
immense=極大的,無限的
immensity=巨大之物,巨大,無限
immerse=浸入,沉浸於
imminent=即將發生的,逼近
immolate=犧牲,焚祭
immune=免疫的
immunity=免疫,豁免
immunize=使免疫
immure=監禁
imp=小鬼,頑童
impact=衝擊,影響
impair=損害,使弱,削弱
impale=刺入,刺中
impalpable=無法觸及的,不易理解的
impart=傳授,告知
impartial=公平的,無私的
impasse=僵局,死路
impassioned=慷慨激昂的
impassive=無動於衷的,冷漠的
impeach=指責,彈劾
impeccable=無瑕疵的
impecunious=一文不名的,貧困的
impede=妨礙
impediment=妨礙,阻礙物
impel=推進,驅使
impending=行將發生的,逼近的
impenetrable=不能穿透的,不可理解的
impenitent=不悔悟的,不知悔改的
imperative=急需的
imperial=帝王的,至尊的
imperious=傲慢的,專橫的
impermanent=暫時的
impermeable=不可滲透的,透不過的,不透水的
impersonate=模仿,扮演
impertinence=無禮,粗魯
imperturbable=冷靜的,沉著的
impervious=不能滲透的
impetuous=衝動的,魯莽的
impetus=推動力,刺激
impinge=侵犯,撞擊
implant=注入,灌輸
implausible=難以置信的
implement=工具,器具,實現,實施
implicate=牽連,牽累,暗示
implication=暗示
implicit=含蓄的,不言而喻的
implode=內爆
implore=哀求,懇求
impolitic=不智的,失策的
imponderable=無法衡量的
import=進口,輸入
importune=強求,不斷請求
impose=徵稅,加於,強加於
imposing=壯麗的,雄偉的
impostor=冒充者,騙子
imposture=冒充
impoverish=使成赤貧
impregnable=攻不破的,征服不了的
impresario=經理人,主辦者
impressed=被打動的,被感動的
impression=印象,感想,蓋印,壓痕
impressionable=受影響的
imprint=蓋印,刻印
impromptu=即席的,即興的
improvident=不節儉的,無遠見的
improvise=即席而作,即興創作
imprudent=輕率的,不智的
impudent=魯莽的,無禮的
impugn=指責,對…表示懷疑
impuissance=無力,虛弱
Impulse=衝動,刺激
impunity=免除懲罰
inadvertence=漫不經心
inalienable=不可剝奪的
inane=無意義的,愚蠢的,空洞的
inanimate=無生命的
inappreciable=微不足道的
inaugural=就職的,開幕的
inaugurate=舉行就職典禮,開創
inborn=天生的,天賦的
incandescence=白炙,炙熱發光
incantation=咒語
incarcerate=下獄,監獄
incarnate=具有肉體的
incendiary=放火的,縱火的
incense=香,香味
incentive=刺激,鼓勵,刺激因素,誘因
inception=開端,開始
incessant=無間斷的,連續的
inch=慢慢前進,慢慢移動
inchoate=剛開始的,為發展的
incidence=事情發生,發生率
incinerate=焚化,毀棄
incipient=初期的,剛出現的
incise=切,切割
incision=切口,切割
incisive=一針見血的
incite=激發,刺激
inclement=嚴酷的,嚴厲的
inclusive=含一切的,範圍廣的
incogitant=無思維能力的,考慮不周的
incommensurate=不成比例的,不相稱的
incompatible=不能和諧共存的
incompetent=無能力的,不能勝任的
incongruity=不協調,不相稱
inconsequential=不重要的,微不足道的
