bewilder=v.使迷惑,混亂
bewildering=adj.令人迷惑的,費解的
bibliography=n.文獻學,参考書目
bibliophile=n.愛書者,藏書家
bicker=v.為小事爭吵
bid=v.命令,出價,投標
bifurcate=v.分為兩支,分岔
bigot=n.(宗教,政治等的),頑固盲從者,盲信者
bile=n.膽汁,憤怒,脾氣乖戾
bilingual=adj.兩種語言的
bilk=v.躲債,騙取
billowy=adj.如波浪般翻滾的
bin=n.大箱子
biosphere=n.生命層,生物圈
biped=n.兩足動物
bit=n.鑽頭,錐
bizarre=adj.奇異的,古怪的
blade=n.刀鋒,刀口
blanch=v.使變白,使(臉色)變蒼白
bland=adj.情緒平穩的,(食物)無味的
blandishment=n.奉承,甜言蜜語
blasphemy=n.褻瀆,瀆神
blast=n.一陣(大風,強風),衝擊波,爆破,枯萎
blatant=adj.厚顏無恥的,顯眼的,炫耀的
blazon=n.紋章,裝飾,精確描繪,宣揚,誇示
bleach=v.漂白,使無色,漂白劑,漂白的行為
bleak=adj.寒冷的,陰沉的,陰鬱的,黯淡的
blemish=v.損害,沾汙,瑕疵,缺點
blight=n.植物枯萎病,使…枯萎
bliss=n.狂喜,極大的幸福,福佑,天賜的福
blithe=adj.快樂的,無憂無慮的
blizzard=n.暴風雪
blockade=v.n.封鎖
blockage=n.障礙物
blooming=adj.有花的,精力旺盛的
blotch=n.(皮膚上的)紅斑點,(墨水等),大斑點
blowhard=n.自吹自擂者
blue=adj.憂傷的,沮喪的
blueprint=n.藍圖,方案,計畫
blunder=v.犯大錯,笨拙地做
blunt=adj.鈍的,直率的,變鈍
blur=n.模糊不清的事物
blurb=n.簡介
blurt=v.脫口而出
blush=v.因某事物臉紅
bluster=v.(指風)猛刮
blustering=adj.大吵大鬧的,恐嚇的
boast=v.n.自誇
bodyguard=n.保鑣
bog=n.沼澤
boggle=v.畏縮不前
bogus=adj.假的
boisterous=adj.指喧鬧的,猛烈的
bolster=n.枕墊,靠墊,支持,鼓勵
bolt=v.急逃,門閂
bombast=n.高調,誇大之辭
bondage=n.奴役,束縛
bonnet=n.圓帽,扁平短帽
boom=n.繁榮長盛時期
boon=n.恩惠,天賜福利
boor=n.舉止粗野的人
boost=v.往上推,增加
bootless=adj.無益處的,無用的
bore=v.鑽孔,使厭煩
boredom=n.令人厭煩的事物
botany=n.植物學
boulder=n.巨礫,大岩石
bouquet=n.花束,芳香
bourgeois=adj.中產階級的
bout=n.一回合,一陣
boycott=v.抵制(貿易),杯葛
brace=v.使穩固,支撐物
bracelet=n.手鐲,臂鐲
bracing=adj.令人振奮的
bracket=n.托架,支架
brag=v.吹噓
braggadocio=n.吹牛大王
braggart=n.吹牛者
braid=n.穗子,髮辮
brake=n.煞車;v.減速
brandish=v.(威脅性地)揮舞
brash=adj.性急的,無禮的
brassy=adj.厚臉皮的;無禮的
brat=n.孩子;頑童
bravado=n.故作勇敢;虛張聲勢
bravura=n.華美樂段;需要高超技巧的演奏片段
brawl=v.n.爭吵;打架
brazen=adj.厚臉皮的
breach=n.裂縫;缺口
breadth=n.寬度
breed=v.繁殖
bribe=v.賄絡
bricklayer=n.砌磚蓋房者;泥瓦匠
bridle=n.馬籠頭;v.抑制,控制
brink=n.(峭壁的)邊沿,邊緣
brisk=adj.快的,敏捷的,活潑的,清新健康的
bristle=n.短而硬的毛髮,(毛)豎起
brittle=adj.易碎的,脆弱的
broach=v.開(瓶),提出(討論)
brochure=n.小冊子,說明書
broker=n.經紀人
bromide=n.平庸的人或話,鎮靜劑,安眠藥
brood=n.一窩幼鳥,孵蛋,冥想,憂思
brook=n.小河
browbeat=v.欺侮,嚇唬,恫嚇
bruise=v.受傷,擦傷,瘀傷
bruit=v.散佈(謠言)
brunt=n.主要衝擊力或影響
brusque=adj.唐突的,魯莽的
brutal=adj.殘忍的,嚴酷的
buck=v.反對,雄鹿,雄兔
bucket=n.圓桶
bucolic=adj.鄉村的,牧羊的
bud=n.芽,花蕾
budge=v.移動一點兒,稍微移動,改變立場
budget=n.預算
buffoon=n.演出時的丑角,粗俗而愚蠢的人
bulb=n.植物的球莖,燈泡
bulge=n.v.膨脹,鼓起
bulk=n.體積,數量,大多數,大身軀
bully=v.以強欺弱,威脅;n.欺負別人,欺負弱小者
bumptious=adj.傲慢的,自誇的
bungle=v.笨拙地做
buoy=n.浮漂,救生圈,支持,鼓勵
buoyant=adj.有浮力的,快樂的,愉快的
bureaucracy=n.官僚政治
burgeon=v.迅速成長,發展
burial=n.埋葬,埋藏
burlesque=n.諷刺或滑稽的戲劇
burnish=v.擦亮,磨光
bust=n.半身(雕)像
butt=v.用頭抵撞,頂撞,粗大的一端,菸蒂
buttress=v.拱牆,拱壁
byline=n.(列作者名字的,)報刊文章首行
byproduct=n.副產品,副作用
bystander=n.旁觀者
byzantine=adj.像迷宮似的,複雜的,難變更的
cabal=n.政治陰謀小集團
cabinet=n.廚櫃,內閣
cache=n.貯藏處,將…藏於
cacophony=n.難聽的聲音,刺耳的聲音
cadet=n.軍校或警官學校的學生
cadge=v.乞討
cajole=v.(以甜言蜜語)哄騙
