serene=清澈的,晴朗的,安靜的
serial=連續的,一系列的
sermon=布道,說教,訓誡
serrated=呈鉅齒狀的
serried=密集的
serviceable=可用的,耐用的
servile=奴性的,百依百順的
servitude=奴役,勞役
setback=挫折
settle=安置於,決定,棲息
settled=固定的
sever=切斷,脫離
severe=嚴格的,兇猛的
sewer=排水溝,下水道
sextant=六分儀(航海定向儀器)
shackle=腳鐐,枷鎖,束縛,羈絆
shale=頁岩(一種由似泥土細粒的沉澱物組成的易碎岩石)
sham=虛假,偽裝
shambles=凌亂景象,雜亂無章
shard=(陶器等)碎片
shattered=粉碎的,破壞的
shavings=刨花
shear=剪(羊毛),剪髮
sheath=(刀、劍)鞘,套
sheathe=將(刀、劍等)插入鞘
shed=流初(眼淚等),(葉子)脫落
sheer=完全的,陡峭的,極薄的
shell=貝殼,砲彈,剝去…的殼
shelter=掩蔽處,掩蔽,庇護,保護
shelve=擱置
sheriff=警常,縣治安官
shield=盾,掩護,遮擋
shiftiness=奸詐
shiftless=沒有決斷力的,偷懶的,無能的
shingle=木瓦,屋頂版,木質小招牌
shipshape=整潔的,井然有序的
shirk=逃避,規避
shoal=淺灘,淺水處,一群(魚等),水淺的
shoddy=劣質的,冒充好貨的
shoot=嫩芽,新芽
shoplift=在商店裡偷竊貨品
shopworn=在商店中陳列舊了的
shoulder=肩,路肩
shove=推擠,猛推
shrewd=判斷敏捷的,精明的
shriek=尖叫
shrine=神龕,聖地
shrink=收縮,皺縮
shroud=壽衣,遮蔽物,覆蓋
shrub=灌木
shrug=聳肩(表示懷疑等)
shuck=(植物的)殼,夾,無用之物
shudder=顫慄,發抖
shun=避免,閃避
shunt=使(火車)轉到另一軌道,轉移方向
sibilant=發出嘶嘶聲的
sibling=兄弟或姊妹
sibyl=女預言家,女先知
sidereal=恆星的
sideshow=雜耍,穿插表演
sidestep=橫跨一步以躲避,迴避
siege=包圍,圍攻
sift=篩,過濾
signal=信號,發信號,顯著的
significant=相當數量的,意義重大的
signify=表示,有重要性的
sill=門檻,窗台
silt=淤泥,淤砂
silversmith=銀匠
simper=痴笑,傻笑
simpleton=笨蛋
simulate=假裝,模仿
simultaneous=同時發生的
sincere=誠實的,正直的,真摯的,純淨的
sinecure=掛名差事,閒職
sinew=腱,肌肉,力量,體力
singe=(輕微地)燒焦,燙焦
singularity=獨特,期點(天文學上密度無窮大、體機無窮小的點)
sinuous=蜿蜒的,迂迴的
sip=啜飲
siren=汽笛,警報器
skeleton=骨架,骨骼,提綱
sketchy=概略的,粗略的
skew=不直的,歪斜的
skewer=(烤肉用的)穿肉叉,用叉穿好
skiff=輕舟,小船
skillet=煎鍋
skim=從液體表面撇去,拂去…表面的浮物,瀏覽,略讀
skimp=節省花費
skinflint=吝嗇鬼
skirmish=小戰,小爭吵
skir=環繞,逃避
skit=幽默諷刺短劇
skyscraper=摩天大樓
slab=厚板,厚塊
slack=懶散的,懈怠的,(繩)鬆弛的,鬆懈,怠惰
slacken=(使)鬆弛,放鬆
sla=爐渣,礦渣
slake=解渴,消渴
slander=誹謗,詆毀
slanderous=誹謗的
slant=傾斜,斜面,看法
slate=石板,候選人名單,提名
slaughter=屠殺,屠宰
sleigh=(馬拉的)雪橇
slew=(使)旋轉,大量
slice=切成片,薄片
slick=熟練的,圓滑的,光滑的
slight=微小的,輕蔑
slippage=滑動,下降
slippery=滑的,狡猾的
slipshod=馬虎的,草率的
slither=(蛇)滑動,扭動前進
sliver=長條,裂成細片
sloppy=邋遢的,不整潔的
slot=狹孔
sloth=懶惰,樹懶(一種動物)
slouch=沒精打采的樣子,沒精打采地坐(站、走)
slough=(蛇等)蛻皮,(蛇等的)蛇皮
sluggard=懶鬼
sluice=水門,水閘,沖洗
slumber=睡眠,安睡
slur=含糊不清地講
slurp=大聲地啜喝
sly=狡猾的,鬼鬼崇崇的
smarmy=虛情假意的
smart=痛苦,劇痛,時髦的,聰明的
smattering=略之,少數
smear=油漬,汙點,弄髒,玷汙
smirk=假笑,得意地笑
smooth=光滑的,平穩的,弄平,使光滑,消除
smother=覆蓋,(使)悶死
smudge=漬痕,汙點,弄髒
smug=自滿的,自命不凡的
smuggle=走私,私運
snare=羅網,陷阱
snarl=糾纏,混亂
snatch=強奪,攫取
sneaking=密密的,不公開的
sneer=嘲笑,鄙視
snide=諷刺的,含沙射影的
snip=剪斷
snitch=告密,偷
snobbish=勢利眼的,假充紳士的
snowdrift=雪堆
snub=冷落,不理睬
snug=溫暖的,舒適的
soak=浸泡,滲透
soar=高飛,翱翔,猛增
sober=清醒的,莊重的
sobriety=節制,莊重
sock=重擊,痛打
sod=草地,草坪
sodden=滲透了的,濕透的
soggy=濕透的
soil=弄髒,汙損
solace=安慰,慰藉
solder=焊接,焊合
solemn=嚴肅的,莊嚴的,黑色的
solemnity=莊嚴,肅穆
solicit=懇求,教唆
solicitous=熱切的,掛念的
solicitude=關懷,牽掛
solidarity=團結,一致
solidify=鞏固,(使)凝固,(使)團結
solitary=孤獨的,隱士
solitude=孤獨
solo=單獨的,獨唱
soluble=可溶的,可以解決的
solvent=有償債能力的
somatic=肉體的
somber=憂鬱的,陰暗的
sonata=【音】奏鳴曲
sonnet=十四行詩
soot=黑煙灰,油煙
soothe=撫慰,減輕
sop=泡過的食品,安慰品,巴結用的物品
sophism=詭辯,詭辯法(術)
sophisticated=老於世故的,(儀器)精密的
