oscillate=擺動,猶豫
osmosis=滲透,潛移默化
osseous=骨的,多骨的
ossify=硬化,骨化,使(傳統)僵化
ostensible=表面上的
ostentation=誇飾,炫耀
ostracism=放逐,排斥
ostracize=放逐,排斥
ostrich=鴕鳥,不接受現實的人
other-directed=受人支配的
otter=水獺
oust=驅逐,把…趕走
outgoing=友善的,即將離去的
outgrowth=自然結果,副產品
outlandish=古怪的
outlet=出口
outline=輪廓,梗概
outmaneuver=以策略制勝的
outmoded=不再流行的
outrage=暴行
outset=開始,開頭
outshine=比…更好
outskirts=郊區,郊外
outspoken=直言不諱的
outstrip=超過,跑過
outwit=以機智勝過
ovation=熱烈的歡迎、鼓掌
overbearing=專橫的,獨斷的
overdose=(藥物)過大的劑量
overdue=過期未付的,逾期的
overexposure=過分暴露,(照相)曝光程度
overflow=溢出,充滿,洋溢
overhaul=徹底檢查,大修
overlap=(部分)重疊
overlook=忽視,俯視
overpowering=壓倒性的,不可抗拒的
overreach=做事過頭
override=不理會,蹂躪,踐踏
overriding=最主要的,優先的
overrule=(高位的人)否決(低位的人或事)
oversee=監督
overshadow=遮蔽,使失色
overstate=誇張,對…言過其實
overt=公開的,非秘密的
overthrow=推翻,終止
overture=前奏曲,序曲
overturn=翻倒,推翻
overwhelm=泛濫,淹沒,壓倒
overwrought=緊張過度的,興奮過度的
owl=貓頭鷹
oxidize=氧化,生銹
pacifist=和平主義者,反戰主義者
pacify=使安靜,撫慰
pack=狼群,一群動物
packed=充滿人的,擁擠的
pact=協定,條約
padding=襯墊,填料
paean=讚美歌,頌歌
pagan=沒有宗教信仰的人,異教徒
pageant=壯觀的遊行,露天歷史劇
painkiller=止痛藥
painstaking=煞費苦心的
palate=上顎,口味,愛好
palatial=宮殿般的,宏偉的
palette=調色板,顏料配置
pall=令人發膩,失去吸引力
palliate=減輕(痛苦),掩飾(罪行)
palliative=緩釋劑,暖和劑,減輕的,緩和的
pallid=蒼白的,沒血色的
palmy=繁榮的,棕櫚的
palpable=可觸知的,明顯的
palpitate=(心臟)急速而不規則地跳動
palter=含糊其詞
paltry=無價值的,微不足道的
pamphlet=小冊子
pan=嚴厲批評
panacea=萬靈藥
panache=炫耀,羽飾
pancreas=胰腺
pandemic=(病)大範圍流行的
pandemonium=喧囂,大混亂
panegyric=頌詞,頌揚
panel=專門小組,儀表板
pang=一陣劇痛
panic=恐慌的,恐慌,驚惶
panorama=概觀,全景
panther=黑豹
pantomime=啞劇
pantry=食品室
papyrus=莎草,莎草紙
parable=寓言,比喻
parabola=拋物線
paradigm=範例,示範
paradox=似非而可能是的理論,矛盾
paragon=模範,典型
parallel=平行的,類似的,平行線,與…相似
parallelism=平行,類似
parameter=參量,變量
paramount=最重要的,最高權力的
paranoia=偏執狂,多疑症
paranoid=偏執狂的,過分懷疑的
paraphrase=解釋,釋義
parasite=食客,寄生物
parch=烘烤,烤焦
pare=削,修剪,削減,縮減
pariah=賤民,被社會遺棄者
parity=(水平、地位、數量等的)同等,相等
parka=派克大衣(防禦風雪的毛皮大衣)
parlance=說法,用語,詞彙
parody=模仿性嘲弄文章或表演,拙劣的模仿
paroxysm=(感情等)突發
parquet=鑽木地板
parry=擋開,避開(武器、問題等)
parse=對…做語法分析
parsimony=過分節儉,吝嗇
partial=局部的,偏袒的
partiality=偏袒,偏心
particular=事實,細節
particularize=詳述,列舉
partisan=黨派支持者,黨徒
partition=隔開,隔牆
passionate=充滿激情的
passive=被動的,缺乏活力的
pastel=彩色粉筆或蠟筆畫,柔和的色彩
pasteurize=加熱殺菌,消毒
pastiche=混合拼湊的作品
pastoral=田園生活的,寧靜的
pastry=糕點,點心
patch=補釘
patent=顯而易見的,專利權(證書)
pathogen=病原體
pathology=病理學
patina=綠鏽,光亮的外表
patrician=貴族
patrimony=祖傳的財產
patriot=愛國者,愛國主義者
patriotism=愛國主義,愛國心
patronage=贊助,惠顧
patronize=以高人一等的態度對待,光顧,惠顧
paucity=小量,缺乏
paunchy=(因肥胖)大肚子的
pauper=貧民,乞丐
peak=憔悴,銷售
pecan=山核桃
peccadillo=小過失
peck=啄食,輕啄
pedagogue=教師,教育者
pedagogy=教育學,教學法
pedal=踏板,腳蹬,騎腳踏車
pedant=迂腐之人,書呆子
pedestal=(石柱或雕像)基座
