chromatic=彩色的,五彩的
chromosome=染色體
chronic=慢性的,長期的
chrysanthemum=菊,菊花
chuckle=輕聲地笑
churl=粗鄙之人
cinder=餘燼,煤渣
cipher=零,無影響力之人,密碼
circuit=環形,環形道,線路,電路
circuitous=迂迴的,繞圈子的
circulate=循環,流通,發行
circumference=周圍,圓周,周長
circumlocution=迂迴累贅的陳述
circumscribe=限制
circumstantial=不重要的,偶然的,描述詳細的
circumvent=迴避,用戰謀戰勝或規避
cistern=貯水池
cite=引用,引述
civil=國內的,公民的,聞名的
civilian=平民
civility=彬彬有禮,斯文,謙恭
claim=要求或索要,聲稱擁有的權利
clairvoyance=超人的洞察力
clam=蛤蜊,蛤肉,守秘密之人
clamor=吵鬧,喧譁
clamp=鉗子
clandestine=秘密的,暗中從事的
clannish=秘密的,暗中從事的
clarify=澄清
clash=衝突,撞擊
clasp=鉤子,扣子,緊握
classify=分類,歸類
clause=從句,子句,（法律等）條款
clay=黏土
cleft=裂縫,劈開的
clemency=溫和,仁慈,寬厚
clement=仁慈的,溫和的
climax=頂點,高潮
clinch=釘牢,最後確定
cling=僅抓住,捨不得放棄
clinical=臨床的,冷靜客觀的
clip=夾子,別針
clipper=大剪刀,快速帆船
clique=朋黨派別,小集團
clog=障礙,阻塞
cloister=修道院
closet=壁櫥,秘密的
clot=凝塊,使凝結成塊
cloture=辯論的終結,結辯
cloudburst=大暴雨,豪雨
clout=用手猛擊,權力,影響力
clown=小丑,扮小丑
cloying=甜的發膩的
clumsy=笨拙的,拙劣的
cluster=串,束,群,成群,成串
coagulant=凝結劑,凝血劑
coagulate=使凝結
coalesce=聯合,結合
coalition=結合,連結
coarse=粗糙的,低劣的,粗俗的
coarsen=使某物變粗糙
coax=哄誘,巧言勸誘
cob=玉米棒子,玉米穗軸,雄天鵝
cobbler=補鞋匠
cocoon=繭
coda=樂曲的尾聲,終章
coddle=溺愛,悉心照料
code=密碼,法典,將某事物編寫成密碼
codify=將法律、規則等編成法典
coerce=強迫,壓制
coercion=強制,高壓統治
coeval=同年代的,同時期的
cogent=有說服力的
cogitate=慎重思考,思索
cognizance=知道的,認識的
cohabit=共棲,同居
coherent=連貫的,一致的
cohesion=內聚力,凝聚力
cohesive=凝聚的
coincide=巧合,一致
colander=濾器,漏勺
cold-blooded=【生】冷血的,殘酷的
collaborate=合作,協作,通敵
collage=拼貼畫
collapse=坍崩,塌陷,虛脫,暈倒
collar=衣領,戴在動物頸部的項圈
collate=對照,核對
collateral=並行的,平行的,旁系的,擔保品
collected=泰然自若的
collection=收藏品
collision=碰撞,衝突
colloquial=口語的,口頭的
colloquium=學術討論會
collude=串通,共謀
colon=冒號
colonize=建立殖民地
colonnade=柱廊
colony=菌群,殖民地
coloration=著色法,染色法,顏色,色澤
colossal=巨大的,龐大的
colossus=巨人,巨型雕像
coltish=似小馬的,不受拘束的,愛嬉鬧的
coma=昏迷狀態
comatose=昏迷的
combat=格鬥,搏鬥
combustible=易燃的,易激動的
comedienne=說笑話,演滑稽劇等女主角,女丑角
comely=動人的,美麗的
comic=可笑的,喜劇的,演劇演員
comity=禮讓,禮儀
comma=逗號
commemorate=紀念（偉人、大事件等）
commence=開始,著手
commencement=開始(大學的)畢業典禮
commensurate=同樣大小的,相稱的,成比例的的
commentary=實況報導,(對書等的)集注
commingle=摻和,混合
commission=委託,佣金
commit=託付,承諾,犯罪
committed=(對事業、本質工作等)盡忠的
commodious=寬敞的
commodity=商品
commonplace=平常的
commonwealth=共和國,聯邦
commotion=騷動,動亂
communal=全體共用的,共享的
commune=公社
communicate=傳遞訊息,溝通
commute=交換,坐公車上下班、通勤
compact=結實的,簡潔的,合同,協議
companion=同伴,同夥,受雇的陪伴人
comparison=比較,對照,比喻
compartment=隔間,車廂
compass=指南針,羅盤,界限,範圍
compassion=同情,憐憫
compatible=和諧共處的,相容的
compatriot=同胞,同國人
compel=強迫
compelling=引起興趣的
compendium=簡要,概略
compensate=補償,賠償
competence=勝任,能力
compile=匯集,編輯
