disfigure=v.毀容
disfranchise=v.剝奪,(某人的)選舉權
disgorge=v.嘔出,(水)流走
disgruntle=v.使不滿意
disguise=v.假扮,掩飾
disgust=n.反感,厭惡
disillusion=v.夢想破滅,醒悟
disinfect=v.殺菌,消毒
disinfectant=n.消毒劑
disinter=v.挖出,挖掘
disinterested=adj.公正的,客觀的
disjunction=n.分離,分裂
disjunctive=adj.分離的,相反的
dislocate=v.使脫臼,把…弄亂
dislodge=v.逐出,取出
dismal=adj.使人悲傷的,陰沉的
dismantle=v.拆除
dismay=n.沮喪,氣餒
disparage=v.貶抑,輕蔑
disparate=adj.迥然不同的
dispassionate=adj.平心靜氣的
dispatch=v.派遣,一下做完,吃完,迅速吃完
dispel=v.驅散,消除
dispensable=adj.不必要的,可有可無的
dispense=v.分配,分發
disperse=v.消散,驅散
displace=v.換置,撤換,使某人某物離開原位
disposable=adj.一次性使用的,用完即丟棄的,可動用的
disposal=n.清除,處理
dispose=v.使傾向,處理掉
disposed=adj.願意的,想幹的,有…的傾向
disposition=n.處理,天性,氣質
disproof=n.反正,反駁
disprove=v.證明…有誤
dispute=v.爭論
disregard=v.n.疏忽,漠視
disrepute=n.名譽不好
disrupt=v.弄亂,擾亂
disruptive=adj.製造混亂的,破壞性的
dissect=v.解剖
dissemble=v.隱藏,掩飾(感受,意圖)
disseminate=v.散布,傳播
dissent=v.不同意,持異議
dissertation=n.專題論文
dissident=n.唱反調者
dissimulate=v.隱藏,掩飾
dissipate=v.(使)驅散,浪費
dissociation=n.分離,脫離關係
dissolute=adj.放蕩的,無節制的
dissolve=v.使固體溶解
dissonant=adj.不和諧的,不一致的
dissuade=v.勸阻,阻止
distant=adj.疏遠的,冷淡的
distend=v.(使)膨脹,脹大
distension=n.膨脹
distill=v.蒸餾
distinct=adj.清楚的,明顯的
distinction=n.區別,差別,知名
distinctive=adj.出眾的
distinguished=adj.著名的,卓越的
distort=v.扭曲,弄歪,變形
distract=v.分心,轉移,使發狂,使困擾
distracted=adj.心煩意亂的,精神不集中的
distraught=adj.心神狂亂的,心煩意亂的
distress=v.痛苦,悲痛
distribute=v.分發,分配某事物
district=n.地區,行政區,(美國各州的)眾議院選區
ditty=n.小曲,小調
diurnal=adj.白晝的,白天的
dive=n.歌劇中的女主角
diver=n.潛水員
diverge=v.分期,分開
diverse=adj.不同的,多樣的
diversity=n.多樣,多樣性,千變萬化
divert=v.使某事物轉向,使娛樂
divest=v.卸下盛裝,剝奪
divestiture=n.脫衣,卸下盛裝,剝奪財產,取消稱號
divine=v.推測,預言
divulge=v.洩露,透露
docile=adj.訊服的,聽話的
doctrinaire=n.空論家,教條的,迂腐的
doctrine=n.教義,主義,學說
document=n.文件,公文,為…提供書面說明
dodder=v.蹣跚,搖擺
dodge=v.閃開,躲避
doff=v.脫掉
dogged=adj.頑強的
doggerel=n.歪詩,打油詩
dogma=n.教條,信條
dogmatism=n.教條主義,武斷
doldrums=n.赤道無風帶,情緒低落
doleful=adj.憂愁的,消沉的
dolorous=adj.悲哀的,憂愁的
dolt=n.傻瓜
domain=v.領土,領域
dome=n.圓頂屋
domesticate=v.馴養
domicile=n.住處,住所
dominant=adj.顯性的,優勢的
dominate=v.控制,支配
donate=v.捐贈,贈送
donor=n.捐贈者,送者,獻血者,供血者
doodle=v.胡畫,亂畫,混時間
dormant=adj.冬眠的,靜止的
dorsal=adj.背部的
dose=n.劑量,一劑
dossier=n.卷宗,檔案
dote=v.溺愛,昏聵
doting=adj.溺愛的
dour=adj.嚴厲的,臉色陰沉的
douse=v.把…浸入水中,熄滅
down=n.羽毛,汗毛,絨毛
downplay=v.貶低,不予重視
downpour=n.暴雨
down-to-earth=adj.實際的
doyen=n.老前輩
drab=adj.土褐色的,無聊的
draconian=adj.嚴厲的,嚴酷的
draft=n.草稿,草案,匯票
draftsmanship=n.起草術,製圖術
drain=v.排出(溝外),喝光
drainage=n.排水,排水系統
drastic=adj.猛烈的,激烈的
drawbridge=n.吊橋
drawl=v.n.慢吞吞地說
dreary=adj.沉悶的,乏味的
dregs=n.遭粕,沉澱,廢物,殘渣
drench=v.使濕透
drill=v.鑽,鑽床
drivel=v.(說)廢話
drizzle=v.下毛毛雨
drizzly=adj.毛毛細雨的
droll=adj.古怪的,好笑的
drone=v.嗡嗡地響,單調地說
droop=v.低垂,沮喪
droplet=n.小水滴
dross=n.浮渣
drought=n.乾旱,乾旱時期
drove=n.畜群,人群
drudgery=n.苦工,苦活,苦差事
dual=adj.雙重的
dubious=adj.可疑的,名聲不大好的
duckling=n.雛鴨,小鴨
duct=n.管道,輸送管,槽
duel=n.決鬥
duet=n.二重唱
dull=adj.不鮮明的,遲鈍的,變遲鈍
dummy=n.人體模型,假人
dune=n.沙丘
dupe=n.上當者,易受騙者
duplicitous=adj.搞兩面派的,雙面人的,奸詐的,雙重的
duplicity=n.欺騙,口是心非
duration=n.持續的時間
duress=n.脅迫
dutiful=adj.恭敬順從的,盡職的
dwarf=n.v.侏儒,矮小的動物或植物,使變矮小
dwelling=n.住處
dwindle=v.變小
dynamic=adj.動態
