dynamo=發電機
dyslexia=誦讀困難,閱讀障礙
dyspeptic=消化不良的,不高興的
earnest=認真的
earplug=耳塞
earring=耳環,耳飾
earshot=聽力所及之範圍
earsplitting=震耳欲聾的
earthly=現世的,塵世的
earthy=粗俗的,粗陋的
easel=黑板,畫架
eavesdrop=偷聽,竊聽
ebb=退潮,衰退
ebullience=精力充沛,洋溢,奔放
eccentric=古怪的,反常的
eclectic=折衷的,綜合性的
eclecticism=折衷主義
ecologist=生態學家,生態學者
economical=經濟的,節約的
ecstasy=狂喜,激情狀態
ecstatic=狂喜的,心花怒放的
eddy=渦,渦流
edifice=宏偉的建築
edify=陶冶,啟發
efface=擦掉,抹去
effervesce=冒泡,熱情洋溢
effete=無生產力的,虛弱的
efficacy=功效,有效性
effluvia=氣味,惡臭,廢料
effrontery=厚顏無恥,魯莽
effulgent=燦爛的
egalitarian=主張人人平等
egocentric=利己的
egotist=自私自利者
egregious=過分的,驚人的
egress=出去,出口
elaborate=精緻的,複雜的
elaboration=詳細的細節,詳盡闡述
elated=得意洋洋的,振奮的
elbow=肘
elegy=哀歌,輓歌
elementary=初級的
elephantine=笨拙的,龐大的
elevate=將某人或某物舉起
elicit=引出,探出,誘出
eligible=合格的,有資格的
eliminate=除去,淘汰
elite=精華,中堅
ellipsis=省略
elliptical=橢圓的
elocution=演說的藝術
elongate=延長,伸長
eloquence=雄辯,口才
elucidate=闡明,說明
elude=逃避,搞不清,使困惑
elusive=難懂的
emaciate=使瘦弱,使憔悴
emanate=散發,發出,發源
emancipate=解放,解除
embargo=禁運令,封港令
embarrass=使忸怩,使難堪
embed=牢牢插入,嵌於
embellish=裝飾,潤飾
embezzlement=貪汙,盜用
emblematic=作為象徵的
embody=表達,體現
embolden=壯膽,鼓勵
emboss=加浮雕花紋於,使凸出
embrace=擁抱,包含
embroider=刺繡,修飾
emend=訂正,校正
emergency=緊急事件,緊急狀況
emigrate=移居外國
eminence=卓越,傑出
eminent=著名的,顯著的
emissary=密使,特使
emit=放射,發出
emollient=潤膚劑
emote=激動地表達感情
empathy=同感,感情移入,全神貫注
emphatic=重視的,強調的
empirical=經驗的,實證的
empiricism=經驗主義
empower=授權,採取行動
empyreal=天空的
emulate=努力趕上或超越
emulsify=使乳化
enact=制定,扮演
enamel=瓷釉
enamored=珍愛的,喜愛的,迷戀的
encapsulate=裝入膠囊,概括,摘要
enchant=使陶醉,施魔法於
enclosure=圈地,圍站,附件
encomiast=讚美者
encomium=讚頌,頌詞
encompass=包圍,圍繞
encounter=遭遇,邂逅
encroach=侵占,侵害,侵入
encumber=妨害,阻礙
encyclopedia=百科全書
endearing=討人喜歡的
endemic=地方性的
endorse=背書,贊同
endow=資助,捐助
endure=忍受,忍耐
enduring=持續的
enervate=使衰弱,使無力
enfeeble=使衰弱,使無力
enfetter=給某人上腳鐐,束缚,使受制於
enflame=使憤怒或激動
engaged=忙碌的,使用中的
engaging=迷人的,吸引注意力的
engender=產生,引起
engrave=在某物上雕刻,牢記,銘記
engross=全神貫注於
engulf=吞噬
enhance=提高,增加,改善
enjoin=命令,吩咐
enlightening=有啟迪作用的,啟發的,令人領悟的
enlist=入伍從軍,徵募
enliven=使更活躍
enmesh=絆住,陷入網中
enmity=敵意,仇恨
ennui=無聊,使無聊
enormity=極惡,窮凶惡極,暴行,巨大
enormous=極大的,巨大的
enrage=激怒,觸怒
enrapture=使狂喜,使高興
ensconce=安置,安頓
ensemble=全體,整體,大合唱
ensign=艦旗
ensue=繼而發生,接踵而來,接著
ensure=確保,擔保
entail=需要,需求,必須
entangle=使糾纏,捲入
enterprise=公司,事業單位
enthralling=迷人的,吸引人的
entice=慫恿,引誘
entirety=整體,全面
entitle=使有權
entity=實體,統一體
entrance=使出神,使入迷
entreat=懇求
entreaty=懇求,哀求
entrée=主菜,獲准進入的權利或特權
entrepreneur=企業家,創業人
