privation=n.喪失,貧困
privilege=n.特權,特別利益
probe=v.探索,探測
probity=n.剛直,正直
proboscis=n.(象)長鼻,(昆蟲等)吸管
proceeds=n.收入
procession=n.行列,前進
proclaim=v.宣告,宣布,顯示
procrastinate=v.耽擱,拖延
proctor=n.代理人,學監
procure=v.取得,獲得
prod=v.刺,捅,激勵
prodigal=adj.揮霍的,揮霍者
prodigious=adj.巨大的
prodigy=n.奇事,奇才
produce=n.產品,農產品
productivity=n.生產力,生產率
profane=v.褻瀆,玷汙,瀆神的
proffer=n.v.獻出,奉獻,贈送,提議,建議
proficient=adj.熟練的,精通的
profile=n.外形,輪廓側面像
profiteer=n.奸商,謀取暴利者
profligate=adj.n.揮金如土的,揮霍者
profound=adj.深的,深刻的,淵博的,深奧的
profuse=adj.很多的,浪費的
progeny=n.後代,子女
prognosis=n.預後,對疾病的發作及結果的預言
prohibitive=adj.抑制的,價格貴的買不起的
projectile=n.拋射物,發射體
projection=n.凸出物
projector=n.電影放映機,幻燈機,投影機
proliferate=v.繁殖,激增
prolific=adj.多產的,多結果的
prolix=adj.囉嗦的,冗長的
prolixity=n.囉嗦
prologue=n.開場白,序幕
prolong=v.延長,拉長
promenade=v.n.散步,開車兜風
prominent=adj.顯著的,著名的
promote=v.提升,促進
prompt=v.促使,激起,敏捷的,迅速的
promulgate=v.頒布(法令),宣傳
prone=adj.俯臥的,傾向於…的,有…傾向的
pronounced=adj.(觀點等)明確的,明顯的
prop=n.支撐物,靠山,支持
propagate=v.繁殖,傳播
propel=v.推進
propensity=n.嗜好,習性
prophecy=n.預言
prophet=n.先知,預言家
prophetic=adj.先知的,預言的,預示的
propitiate=v.討好,撫慰
propitious=adj.極力的,有力的
proposal=n.堤岸,建議
proposition=n.看法,提議
proprietary=adj.私有的
propriety=n.禮節,適當
propulsion=n.推進力
prosaic=adj.單調的,無趣的
proscribe=v.禁止
prose=n.散文
prosecute=v.告發,檢舉
prosecution=n.起訴,實行,經營,執行
proselytize=v.使…皈依
prospect=v.n.勘探,期望,前景
prosperity=n.繁榮,幸運,健康
prosperous=adj.繁榮富強的
prostrate=adj.俯臥的,沮喪的,使下跪,鞠躬
protagonist=n.提議者,支持者
protean=adj.變化多端的,多變的
protest=n.v.提議,反對
protocol=n.外交禮節,提議,草案
prototype=n.圓形,典型
protract=v.延長,拖長
protuberant=adj.凸出的,隆起的
provenance=n.(藝術等的)出處,起源
provender=n.(牛,馬吃的),草料,糧秣
provident=adj.深謀遠慮的,節儉的
providential=adj.幸運的,恰到好處的
provincial=adj.偏狹的,粗俗的
provision=n.(糧食)供應,(法律等)條款
provisional=adj.暫時的,臨時的
provisory=adj.有附帶條件的
provocation=n.挑釁,激怒
prowess=n.勇敢,不凡的能力
prowl=v.潛行於,慢慢的漫遊
proximate=adj.即將來臨的,接近的
prude=n.過分守禮的人
prudent=adj.審慎的,三思而後行的,精明的,節儉的
prudish=adj.過分守禮的,假道學的
prune=n.v.梅乾,修剪
pry=v.刺探,撬開
pseudonym=n.假名,筆名
psyche=n.心智,心靈,精神
psychology=n.心理學,心理狀態
publicize=v.引人注意,宣傳
pucker=v.起皺,皺摺
puckish=adj.淘氣的
puddle=n.水坑,窯
puerile=adj.幼稚的,兒童的
pugilism=n.拳擊,搏鬥
pugilist=n.拳擊手,拳師
pugnacious=adj.好鬥的
puissance=n.權力
puissant=adj.強有力的,強大的
pulchritude=n.美麗
pullet=n.小母雞
pulley=n.滑輪,滑稽
pulp=n.果肉醬,菜泥
pulse=v.n.搏動,跳動,脈動,脈衝
pulverize=v.壓成細粉,磨成粉末,徹底擊敗,摧毀
pun=n.雙關語
punch=v.以拳猛擊,打洞
punctilious=adj.謹小慎微的,一絲不苟的
puncture=v.刺穿,刺破,刺孔,穿孔
pundit=n.權威人士,專家
pungent=adj.味道刺激的,苛刻的
puny=adj.弱小的,發育不良的
purchase=n.支點,槓桿
purgative=n.瀉藥
purgatory=n.煉獄,受苦受難的地方
purge=v.清洗,洗滌
purify=v.使潔淨,淨化
purity=n.潔淨,純淨,純度
purlieu=n.(常用複數形)附近地區,常逗留之處
purloin=v.偷竊
purported=adj.謠傳的,聲張的,號稱的
pursue=v.追趕,追求,追蹤
purvey=v.(大量)供給,供應
pusillanimous=adj.膽小的
pylon=n.高壓電線架
pyre=n.火葬用的柴堆
quack=n.冒充內行之人,庸醫
quaff=v.痛飲,暢飲
quail=v.畏懼,顫抖
quaint=adj.離奇有趣的
qualified=adj.有資格的,有限制的
qualms=n.(成用複數形)(尤指關良心問題)疑慮
quandary=n.困惑,進退兩難
quantum=n.量子,定量
quarantine=n.隔離檢疫期,隔離
query=n.獵物
quartet=n.四重奏,四重唱
quash=v.鎮壓,取消,宣布..無效
quaver=v.發顫音,顫抖,顫音
quay=n.碼頭
quell=v.制止,鎮壓
quench=v.熄滅,抑制(欲望)
querulous=adj.抱怨,多牢騷
quest=v.搜尋,探求
