content=知足的,滿意的,內容,滿意
contented=心滿意足的
contention=爭論,論點
contentious=好辯的,善爭吵的
contest=競爭,對…表示懷疑
context=(語句等的)上下文
contiguous=接壤的,接近的
continent=自制的,大陸
contingent=意外的,視情況或條件而定的
contort=(使)扭曲,歪曲
contraband=違禁品,走私貨
contract=合同,合約,訂合同,締約,收縮
contradict=反駁,駁斥
contrast=對比,對照
contravene=違背(法規,習俗等)
contrite=悔罪的,悔過的,痛悔的
contrive=計畫,設計
contrived=不自然的,做作的
control=實驗對照組
controversial=引起或可能引起爭論的
controvert=反駁,駁斥
contumacious=違抗的,不服從的
conundrum=(答案有雙關意義的),謎語,難題
convalesce=(疾病),康復,復原
convalescent=康復中的(病人)
convenience=便利,有益,方便(的用具,機械等)
conventional=因循守舊的,傳統的
converge=匯集,集中於一點
convergent=匯集的
conversant=精通的,熟知的
converse=談話,逆向的,相反的事務
convert=使改變(信仰等),改變信仰的人
convertible=可轉換的,敞篷車
convey=運載,運送,表達
convict=定罪,罪犯
conviction=判罪,堅信
convince=使某人確信,說服
convivial=歡樂的,狂歡的
conviviality=歡樂,愛交際的性格
convoke=召集,(會議等)
convoluted=旋繞的,費解的
convulse=使震動,震驚
convulsion=騷動,痙攣
coop=(雞)籠,欄
cooperate=與他人合作
coordinate=同等物,座標,同等的,使各部分協調,調和
copious=豐富的,多產的
cord=考得,(木材堆的體積單位,等於128立方英尺,3.6246立方米),繩索
core=果心,果核,核心,去掉某物的中心部分
cornucopia=象徵豐收的羊角(羊角裝飾器內盛滿花,果,穀物等以示富饒)
coronation=加冕
corporate=團體的,共同的
corporeal=肉體的,身體的,物質的
corpuscle=血球,細胞
corral=(牛,馬,等)畜欄
correspondent=符合的,記者
corroborate=支持或證實,強化
corrode=腐蝕,侵蝕
corrosive=腐蝕性的,蝕壞的
corrugate=(使)起波浪型,波紋,起皺紋
corrupt=墮落的,腐敗的,文體有錯誤的
cosmic=宇宙的
cosmopolitan=世界主義者,四海為家的人
cosmopolitanism=世界性,世界主義
cosmos=宇宙
cosset=寵愛,溺愛
costume=服裝,劇裝,戲服
coterie=(有共同興趣的)小團體,夥伴
coterminous=毗連的,有共同邊界的
cougar=美洲豹
countenance=支持,贊成,容忍,表情
counteract=對抗,消除,抵消
counterbalance=起平衡作用,使平衡
counterfeit=偽造,仿造
countermand=撤回(命令),取消(訂貨)
counterpart=相對應或具有相同功能的人或物
counterproductive=事與願違的
coup=意外而成功的行動
court=法庭,庭院,宮廷,朝廷,獻殷勤,追求
covenant=契約,立書保證
covert=秘密的,隱密的
covet=貪求,忘想
cow=威脅
coward=膽小鬼
cower=畏縮,蜷縮
coy=靦腆的,忸怩的
cozen=欺騙,哄騙
crab=蟹,螃蟹,抱怨,發脾氣
crabbed=暴躁的
crack=爆裂聲,裂縫,裂開,破解,破譯
craft=行業,手藝
cram=填塞,塞滿,臨時抱佛腳,為考試而學智
cramp=鐵箍,鐵鉗,夾子,把…箍緊,鉗緊
cranky=怪癖的,任性的,不穩的
crass=愚鈍的,粗糙的
crate=簍,板條箱
crater=火山口
cravat=領巾,領結
craven=懦弱的,畏縮的
craving=強烈的願望,渴望
crayon=彩色蠟筆(粉筆),或其繪畫
crease=摺縫,皺痕
credence=相信,信任
credible=可信的,可靠的
credit=賒購,賒帳,信任,(電影)片尾字幕
credulous=輕信的,易信的
creek=小灣,小溪
creep=匍匐前進,旁行,悄悄地移動,躡手躡足地走
crescendo=漸強,高潮
crest=山頂,浪尖,羽冠
crestfallen=挫敗的,失望的
cringe=畏縮,諂媚
cringing=諂媚(的),奉承(的)
criteria=評判標準
criterion=評判的標準,尺度
critic=批評者
critical=挑毛病的,關鍵的,危急的
critique=評論,批評性的分析
croak=蛙鳴聲,發牢騷,抱怨
crochet=勾針織物,用勾針編織
crockery=陶器,瓦器
cronyism=任人為親,對好朋有的偏袒
crook=使彎曲,鉤狀物
cross=生氣的,壞脾氣的
crouch=蹲伏,彎腰
crucial=決定性的
crudity=粗糙,生硬
crumb=餅屑,麵包屑
crumble=弄碎,崩毀
crumple=弄縐,破裂
crusade=維護裡想,原則而進行的運動或鬥爭,聖戰
crust=硬的表面,(一片)麵包片,地殼
crutch=拐杖,支持
crux=關鍵,癥結所在
cryptic=密密的,神秘的
cub=幼獸,年輕無經驗的人
cubicle=大房間中隔出的小室
cue=暗示,提示
cuisine=烹飪
culinary=廚房的,烹調的
culmination=頂點,結果
culpable=有罪的,該受譴責的
cult=宗派,崇拜
cultivate=種植,向…討好,結交
cultivated=耕種的,栽植的,有修養的
