attenuate=v.變薄,變弱
attest=v.證明為真
attic=n.閣樓,頂樓
attorney=n.律師
attribute=n.屬性,品質
attune=v.使調和
auction=n.拍賣
audacious=adj.大膽的,無畏的
audible=adj.聽得見的
augment=v.增大,增加,增值
augur=n.占卜師,占卜,預言
august=adj.威嚴的,高貴的
auspices=n.資助,贊助
auspicious=adj.吉兆的,吉利的
austere=adj.樸素的
authentic=adj.真正的,法律證實的
authoritarian=n.獨裁主義者,極權主義者
autobiography=n.自傳
autocrat=n.獨裁者
autonomy=n.自治,獨立
auxiliary=adj.輔助的,協助的,附加的
available=adj.可用的,可得到的
avalanche=n.雪崩
avarice=n.貪財,貪婪
avenge=v.為…復仇,為…報仇
aver=v.極力聲明,斷言,確證
averse=adj.不願的,反對的
aversion=n.嫌惡,憎恨
avert=v.避免,防止,避開
aviary=n.大鳥籠,鳥舍
avid=adj.渴望的,熱心的
avoid=v.避開,躲避
avow=v.承認,公開宣稱
awe=n.v.敬畏
awe-inspiring=adj.令人敬畏的
awkward=adj.笨拙的,難用的,造成不便的,尷尬的
awl=n.(鑽皮革的)尖鑽,錐子
awning=n.遮陽篷,雨篷
awry=adj.扭曲的,走樣的
axiom=n.公理,定理
axis=n.軸(常為虛構之線,如地球軸)
axle=n.輪軸(連接兩個車輪的軸)
babble=v.胡言亂語,牙牙學語,喋喋不休
backdrop=n.(事情的)背景,背景幕布
backhanded=adj.間接的,反手擊球的
bacterium=n.細菌
badge=n.徽章(如校徽的)
badger=n.獾,一再煩憂,一再要求
badinage=n.開玩笑,打趣
bail=n.保釋金,保釋
bait=n.誘餌,逗弄,激怒
bale=n.大包裹,災禍,不幸
baleful=adj.有害的,邪惡的,惡意的
balk=n.大方木材,樑木,妨礙,(因困難的)不願前進或從事某事
ballad=n.歌謠,小曲
ballast=n.(船等)壓艙物
ballerina=n.芭蕾舞女演員
balloon=n.氣球;v.快速增加,激增
ballot=n.v.投票
balm=n.香油,藥膏,鎮痛劑,安慰物
balmy=adj.(氣候)溫和的,芳香的,能止痛的
ban=n.禁令,明令禁止
banal=adj.乏味的,陳腐的
band=n.帶子,收音機波動
bandage=n.繃帶,用繃帶包紮
bane=n.禍根
banish=v.放逐某人
banister=n.(樓梯的)欄杆
bankrupt=adj.破產的
banquet=n.宴會,盛宴
banter=n.打趣,玩笑
bar=v.禁止,阻擋,條棒
barb=n.(魚鉤的)倒鉤,批評的話,嚴厲的批評
barbarous=adj.野蠻的,粗俗的,殘暴的
barbecue=n.烤肉架,烤肉
bard=n.吟遊詩人
bare=v.暴露,赤裸的
barefaced=adj.厚顏無恥的,公然的
bargain=n.交易,物美價廉的東西,討價還價
barge=n.平底貨船,駁船
bark=v.n.犬吠,樹皮
barn=n.穀倉
barometer=n.氣壓計,晴雨錶
baroque=n.adj.巴洛克式風格(的)(藝術建築等)過分雕琢
barrage=n.彈幕
barren=adj.貧瘠的,不育的,不結果實的
barricade=v.設柵阻擋,設置路障,柵欄,路障
barrier=n.路障,阻礙
barter=v.易貨貿易,以物易物
base=adj.卑鄙的
bask=v.曬太陽,取暖
baste=v.倒油脂於(烤肉上,以防烤焦)
batch=n.一批,一爐
bathetic=adj.假作悲傷的,陳腐的
baton=n.(指揮家用的)指揮棒,警棍
battalion=n.軍營,軍隊
bauxite=n.鋁土岩
bawdy=adj.淫猥的,好色的
bazaar=n.集市,商店集中區,商場
beacon=n.烽火,燈塔
beam=n.大樑,光線
bearing=n.關係,關聯,意義
beat=v.心跳,跳動
bedeck=v.裝飾,修飾
bedlam=n.混亂,騷亂
befuddlement=n.迷惑不解
begrudge=v.吝嗇,勉強給
beholder=n.目睹者,旁觀者
belabor=v.過分冗長地坐或說
belated=adj.來得太遲的
beleaguer=v.圍攻,騷擾
belie=v.掩飾,證明為假
belittle=v.輕視,貶抑
bellicose=adj.好戰的,好鬥的
belligerence=n.交戰,好鬥性,爭鬥性
bellwether=n.領導者,領頭羊
bench=n.法官席,長凳
benediction=n.祝福,祈禱
benefactor=n.行善者,捐助者
benevolent=adj.善心的,仁心的
benign=adj.慈祥的
benison=n.祝福,賜福
bent=n.特長,愛好,彎曲的
bequeath=v.遺贈
bequest=n.遺產,遺贈物
berate=v.猛烈責罵,痛罵
bereft=adj.被剝奪的,喪失的
beset=v.鑲嵌,困擾
besiege=v.圍攻,困擾
besmirch=v.誹謗
bestial=adj.野獸的,殘忍的
bestow=v.給予,賜贈
betray=v.背叛
betroth=v.許配,和…訂婚
beverage=n.飲料
