abase=降低自己,貶抑,使卑下
abduct=綁架,拐走
abnegation=放棄,自我犧牲
aboriginal=原始居民,土著
abortive=無結果的,失敗的
abound=充滿,富於
abrupt=突然的,意外的,唐突的
abstinent=飲食有毒的,有節制的,禁慾的
acarpous=不結果實的
access=得到,使用
acerbity=澀,酸,刻薄
achromatic=非色彩的,無色的
acronym=首字母縮略表
actuarial=精算的,保險計算的
actuate=驅使,激勵
addle=使腐壞,使混亂
adduce=給予,舉出
adjudicate=充當裁判,判決
ad-lib=臨時講話,即興表演
advert=注意,留意
aeronautics=航空學
aftermath=事件的後果,餘波
agape=大張著的
aghast=驚駭的,嚇呆的
ailment=疾病
albino=白化病者,白化變種
alliterate=押頭韻
almond=杏樹,杏仁
alms=施捨物,救濟品
ambience=環境,氣氛
ambrosial=芳香的,特別美味的
ambulatory=步行的
amethyst=紫水晶
amiss=有毛病地,出差錯地
amoral=與道德無關的
amputate=截肢
anemic=貧血的,患貧血病的
annex=附件
anodyne=止痛藥
antedate=寫上較早日期,早於
anthropoid=像人類的,類人猿
aperture=孔隙,窄的缺口
apothegm=格言,警句
apotheosis=神話,典範
appendage=附加物
aquiline=鷹的,似鷹的
arachnid=蜘蛛類節肢動物
archer=弓箭手,射手
arraign=傳訊,指責
artillery=大砲,砲兵
asinine=愚笨的
askance=側目而視,瞟
askew=歪斜的
asphalt=瀝青
asphyxia=窒息
astigmatic=散光的,亂視的
atheism=無神論
atone=贖罪,補償
attire=穿著,裝飾,好衣服
attrition=摩擦,磨損
auger=螺絲鑽,鑽孔機
augmentation=增加
aureole=日冕,光輪
auricular=耳的
automation=自動裝置
avowal=聲明
avuncular=伯父的
azure=天藍色,蔚藍的
bacchanal=狂歡會
backslide=故態復萌
backwater=死水,閉塞地區
baffle=使困惑,難倒
balky=停止不前的,倔強的
bamboozle=欺騙,隱瞞
bandy=來回拋球,輕率談論
bar code=條形碼,電腦條碼
barbarian=野蠻人
baron=貴族,巨頭
barrister=訟務,律師
bassoon=低音管,巴鬆管
bather=入浴者,浴療者
bauble=花哨的小玩意兒,沒價值的東西
bawl=大叫,大喊
beatific=祝福的,快樂的
beckon=召喚某人,示意
bedizen=把…裝飾得艷麗而俗氣
bedraggled=弄濕的,凌亂不堪的
beet=甜菜
befuddle=使迷惑,使為難,使酒醉昏迷
beget=產生,引起
beguile=欺騙,誘騙
behold=目睹,看見
beholden=感激某人的,欠人情的
behoove=應該,有必要,適宜
belch=打嗝,噴出
belongings=所有物,財產
bemused=茫然的,困惑的
bereave=喪親,奪去
berserk=狂怒的,瘋狂的
betoken=預示,表示
bewitching=迷人的
bibulous=高度吸收的,嗜酒的
biennial=兩年一次的
bilious=膽汁質的,壞脾氣的
billow=巨浪,翻騰
blackball=投反對票以阻止
blackmail=敲詐,勒索
blare=高聲鳴叫
blasé=厭倦享樂的,冷漠的
bleachers=露天座位
bloated=腫脹的,傲慢的
blossom=花,開花
bludgeon=大頭棒
bluff=愚弄
bode=預示
boding=凶兆,前兆,預感,凶兆的
bohemian=放蕩不羈的
bombardment=炮炸,炮轟
bonhomie=好性情,溫和,和藹
boo=作噓聲,噓,用噓聲表示不滿,蔑視或反對
botch=弄壞某事
bottleneck=瓶頸口,交通易阻塞的狹口
bough=粗大的樹枝或樹幹
bounteous=慷慨的,豐富的
bovine=牛的,遲鈍的
bowdlerize=刪除,刪改
bower=涼亭,樹蔭下涼快之處
brackish=略鹹的,不好吃的
brattish=討厭的,寵壞的,不禮貌的
brawny=強壯的
bray=大聲而刺耳地發出
breezeway=有屋頂的通路
brim=邊,緣,盈滿
brindled=有棕色斑紋的
brocade=織錦
broil=烤
brooch=胸針
browse=吃嫩葉或草,嫩葉,嫩芽
bubble=起泡,氣泡,水泡
buckle=皮帶扣環,扣緊
buffer=緩衝,為…充當緩衝器
bugaboo=嚇人的東西,妖怪
buggy=輕型馬車,嬰兒車
bullion=金條,銀條
bumble=說話含糊,拙劣地做
bump=碰撞,碰撞聲
bumpkinly=鄉巴佬的
burrow=挖掘,鑽進,翻尋
buxom=體態豐滿的
cachet=贊同的標誌,優越的標誌,印章,膠囊
cactus=仙人掌
cadaver=屍體
cadence=抑揚頓挫,節奏,韻律
calibre=口徑,品德,才能
callus=老繭,胼胝
canard=謠言,假新聞
canker=潰瘍病,禍害
cantata=清唱劇,大合唱
capacious=容量大的,寬敞的
caper=雀躍,歡蹦
capitalize=資本化,獲利,利用
capitation=人頭稅
capsize=使船翻,傾覆
carat=克拉,開
careen=傾斜,使傾斜
carnage=大屠殺,殘殺
carpentry=木工工作
cascade=小瀑布
cautionary=勸人謹慎的,警戒的
cavalcade=騎兵隊伍
celerity=快速,迅速
celibate=獨身者
cell=單人牢房
cemetery=墳墓,公墓
centrifugal=離心的
centripetal=向心的
cephalic=頭的,頭部的
chaperone=女伴
chasten=改正,磨練
checkered=盛衰無常的
chic=漂亮的,時髦的
chirp=唧唧叫
chore=家務瑣事,討厭的工作
chortle=開心地笑
chunk=短厚塊狀物,大量
ciliate=有纖毛的,有睫毛的
cineaste=影迷,熱衷於電影的人
circumlocutory=委婉曲折的,迂迴的
citation=引證,引用文,傳票
clairvoyant=透視的,有洞察力的
clench=握緊,咬緊
cliché=陳腐的
closed-minded=倔強的,頑固的
closure=關閉,終止
cloy=生膩,吃膩
coat=塗抹
coffer=保險櫃
cognate=同詞源的,同類的
cognomen=姓,名字
colloquy=交談,會談
colt=小熊駒,新手
columnist=專欄作家
comestible=食物,食品,可吃的
commiserate=同情,憐憫
complexion=膚色,外表特徵
complicity=合謀,串通
comport=舉止
compulsory=強制性的,命令性的
concentric=有同一中心的
concoct=調製,捏造
condign=罪有應得的,適宜的
condiment=調味品,作料
condole=向…吊慰
condor=禿鷹,神鷹
confidant=心腹朋友,知己,密友
congenital=先天的,天生的
conjugal=婚姻的,夫妻之間的
connubial=婚姻的,夫妻的
consecrate=用作祭祀,獻給,使神聖
consonance=一致,調和,和音
consort=結交,配對,配偶
conspectus=概要,大綱
constringe=使收縮,使收斂,壓縮
contumacy=抗命,不服從
contumely=無禮,傲慢
convene=集合
convoy=護航,護送
cordial=熱誠的,興奮劑
cornet=短號,圓錐形蛋捲
corny=平淡無奇的,鄉巴佬的
corporal=肉體的,身體的
corpulent=肥胖的
corpus=全集,全部資料
coruscate=閃亮
cosy=(英)溫暖而舒適的
cozy=(美)溫暖而舒適的
counterpoise=平均,平衡
coven=女巫的集會
crafty=狡詐的,熟練的
crag=懸崖,峭壁
credo=信條
crepuscular=朦朧的,微明的
crevice=缺口,裂縫
crinkle=變皺,皺紋
cripple=跛子,殘廢
croon=低聲歌唱
crotchety=脾氣壞的
crypt=地下室
cuddle=摟抱,擁抱
cuff=袖口
culprit=犯罪者
cumber=拖累,妨礙
curd=凝乳
curfew=宵禁
currish=下賤的,雜種的
cursive=草書的
curvaceous=婀娜多姿的,曲線的
cygnet=小天鵝
cynosure=指標
dab=輕拍
dalliance=虛度光陰,調情
damn=嚴厲地批評,譴責,該死的
damper=起抑製作用的因素,節氣閥,斷音裝置
dangle=搖擺,懸盪,懸而未定,使不定地懸著或一直沒有解決
dank=陰濕的,陰冷的
dashing=時髦的,活躍的,衝勁足的
dastard=懦夫,膽小的人
daub=塗抹,亂畫
daubster=拙劣的畫家
daze=使茫然,使眩暈
debar=阻止
debility=衰弱,虛弱
debonair=迷人的,友好的
decamp=離營,匆忙而秘密地離開
decant=輕輕倒出
decentralize=分散,權力下放
declassify=撤銷保密
declination=傾斜,衰微
decoy=誘騙
decree=命令,法令,頒布命令
defalcate=盜用公款
defame=誹謗,中傷
defoliant=脫葉劑,落葉劑
defoliate=落葉
deforest=採伐森林,清除樹林
defray=付款
defunct=死亡的
delectation=享受,愉快
demarcate=劃分,劃界
demeanour=舉止,行為
demented=瘋狂的
demure=嚴肅的,矜持的
denominate=命名,取名
denunciate=公開指責,公然抨擊,譴責
deportment=風度,舉止
deposit=存放,使淤積
depredation=劫掠,蹂躪
depressant=有鎮靜作用的,鎮靜劑
depute=派…為代表或代理
deputize=代替某人行事或說話
derangement=精神錯亂
desalinize=除去鹽分
desideratum=必需品
designate=指明,指出,任命,指派,已任命但還未就職的
desirous=渴望的
desolate=荒涼的,被遺棄的
desperado=亡命之徒
despoil=奪取,搶奪
destitute=貧乏的,窮困的
destructible=可破壞的
desuetude=廢止,不用
detestable=嫌惡的,可憎的,可厭惡的
detonate=爆炸,引爆
detract=減去,貶低,轉移
devolve=移交給某人
diabolic=惡魔的,魔鬼性格的
dictator=獨裁者
dictum=格言,聲明
dietetics=飲食學,營養學
dignitary=顯要人物
dike=堤防
dilapidation=破舊,荒廢
diminuendo=漸弱
diocesan=主教管區的
dipsomania=嗜酒症
disavow=否認,否定,抵賴
disband=解散
disclaimer=否認,拒絕
disembody=使脫離實體,使脫離現實
disfranchise=剝奪…的權利
dishearten=使…灰心
dishevel=使蓬亂,使頭髮凌亂
disheveled=凌亂的
disintegrate=分裂成小片,瓦解
disport=玩耍,嬉戲
disquisition=長篇演講,專題論文
dissect=仔細分析,剖析
dissection=解剖,剖析
dissociate=分離,游離,分裂
distain=貶損,傷害名譽
distal=遠離中心的,末梢的
distention=膨脹
distrait=心不在焉的
ditch=溝,溝渠,壕溝
divagate=離題,飄泊
dock=剪短
doggo=隱藏著
dotage=老年糊塗,溺愛
double-cross=欺騙,出賣
dowdy=不整潔的,過舊的
dowry=嫁妝,妝奩
doze=瞌睡,假寐
dribble=往下滴,淌
drollery=笑談,滑稽
ductile=易延展的
dulcet=美妙的
dullard=愚人,笨蛋
dumbfound=使…驚訝發楞
dunce=笨人
eaglet=小鷹
earthshaking=極其重大或重要的
ecdysis=蛻皮,換羽毛
éclat=輝煌成就
eclogue=田園詩,牧歌
ecumenical=世界範圍的
edict=法令,命令
eerie=可怕的,陰森恐怖的
effeminate=缺乏勇氣的,柔弱的
effigy=模擬像
egoism=利己主義
ejaculate=突然叫出或說出
electorate=選民,選區,有選舉權者
elixir=萬靈藥,長生不老藥
emasculate=削弱,閹割,柔弱的
embankment=堤岸,路基
embitter=使痛苦,使難受
emblazon=以紋章或其他方式裝飾
embodiment=化身,體現
embroil=牽連,捲入糾紛
embryonic=胚胎的,萌芽期的
emerald=翡翠,翠綠色的
emolument=報酬,薪水
employ=使用
empyrean=天空,天神居處
encipher=譯成密碼
encyclopedic=廣博的,知識淵博的
endue=賦予
engrossment=正式謄寫的文件,專注
ennoble=授予爵位,使高貴
enshrine=奉為神聖
enslave=奴役
ensnare=誘入陷阱,進入羅網
enthrall=迷惑,迷住
entourage=隨從,環境
entrench=挖壕溝,確立
entwine=使纏繞,交織
environs=郊外,郊區
envisage=正視,想像
epicurean=好享樂的,享樂主義的
episode=一段情節
epistolary=書信體的
equestrian=騎師,騎馬的
escort=護送,護送者
estrange=使疏遠
estuary=河口,三角洲
eugenic=優生的
even-tempered=性情平和的,不易生氣的
everlasting=永遠的
evildoer=壞人,壞蛋
eviscerate=取出腸及內臟
exceptionable=引起反感的
excerpt=摘錄,選錄,節錄
exchequer=國庫,財源
excogitate=認真想出
excruciate=施酷刑,拷問,折磨
execration=憎恨,厭惡
exhume=掘出,挖掘
exiguous=太少的,不足的
expatiate=細說,詳述
expatriate=驅逐出國
expiation=贖罪
explicable=可解釋的
expropriate=充公,沒收
expulsion=驅逐,開除
extradite=引渡回國,拿獲歸案
extrinsic=外來的,外在的,外部的
extrude=擠出,逐出,突出
exultant=非常高興的,歡躍的
fabulous=驚人的
facsimile=複製本,摹本
factitious=人為的,不真實的
fag=若干,苦工
fail-safe=自動防故障裝置
fainthearted=懦弱的,無精神的,膽小的
fail-minded=公平的,公正的
fake=偽造,佯裝
falsify=篡改,說謊
fanfare=誇耀性遊行,嘹亮的喇叭聲
fantasia=幻想曲,組合樂曲
farrow=生產,一窩小豬
fascia=飾帶,招牌
fascinate=迷惑,迷住
fealty=效忠
febrile=發燒的,熱病的
feisty=活躍的,易怒的
felicitate=祝賀,慶祝
feline=貓科的
fencing=劍術,擊劍法
ferocious=兇猛的,殘暴的
ferry=渡船,渡口,運送
festal=節日的,歡樂的
fetching=動人的,迷人的
fetish=神物,偶像
fibrous=纖維的
fiend=惡魔,魔鬼
filament=燈絲,細絲
filch=偷
filial=子女的
fillet=束髮帶,魚肉片
finable=應罰款的
finery=華麗優雅的服飾或裝飾
firebrand=燃燒的木塊,引起動亂的人
fishery=漁場,漁業
fissile=易分裂的
fitful=一陣陣的,不安的
flabby=鬆軟的,意志薄弱的
flagellate=鞭打,鞭笞
flair=天賦,本領,才華
flannel=法蘭絨
flatulence=腸胃氣脹
flavoring=香料,調味品
flay=剝皮,榨取,嚴厲指責
fleck=斑點,微粒
fleece=生羊皮,羊毛,騙取
fleet=快速的,消磨,疾馳,飛逝,掠過
flick=輕打,輕彈
flicker=閃爍,搖曳
floppy=鬆軟的,衰弱的
florescence=繁花時期
flunk=考試不及格
fodder=草料
fondle=撫弄,撫摸
foothold=立足點,根據地
footle=胡鬧,浪費
fop=花花公子
foreordain=預先註定
foray=突襲,偷襲
forebear=祖宗,祖先
foreclose=排除,取消抵押品的贖回權
forensic=法醫學
foreword=前言,序
forfeiture=喪失
forlorn=孤獨的,淒涼的
formative=形成的,影響發展的
forswear=誓絕,放棄
fort=要塞,城堡
fractional=微小的,極小的
fraternal=兄弟的,友善的
fraternity=同類人,友愛
fray=吵架,打鬥,磨破
freak=怪物,奇事,反常的
fretwork=格子細工
frisk=歡躍,娛樂
fritter=愚蠢地浪費
frolic=嬉戲,雀躍
frolicsome=快活的,歡樂的
frowzy=不整潔的,污穢的
fructify=結果實,成功
funereal=適於葬禮的,憂鬱的
furbish=磨光,刷新
fury=狂怒,狂暴,激烈,狂怒的人,復仇女神
fustian=空洞的話,無意義的高調
gab=饒舌,愛說話,空談,瞎扯,閒逛,遊蕩
gabble=急促而不清楚地說
gaiety=歡樂,快活
gale=狂風,一陣
gallop=飛奔,疾馳
gallows=絞刑架,絞台
gamut=全音階,全部知識
gander=雄鵝,笨人,閒逛
gangling=瘦長難看的
gangly=身材瘦長的
gangrene=壞疽
garland=花環,獎品
garret=閣樓,頂樓小室
gastric=胃的,胃部的
gastritis=胃炎
gastronomy=美食法
gauche=笨拙的,不會社交的
gaunt=憔悴的,瘦削的
genuflect=屈膝半跪,屈從
gestate=懷孕,孕育
gesticulate=做手勢表達
ghastly=可怕的,驚人的,慘白的
girdle=腰帶,轉繞物,環繞
glamorousx=腰帶,轉繞物,環繞
gleam=亮光,閃光,使閃光
glee=歡喜,高興
glimpse=瞥見,看一眼
glitter=閃爍,閃耀,燦爛的光華,誘惑力,魅力
gloaming=黃昏,薄暮
glorify=吹捧,美化
gloss-over=潦草地或敷衍地處理某事
gnat=對小事斤斤計較,瑣事,小昆蟲,蚊子
gnawing=咬,啃;痛苦,持續的疼痛
gnome=地下寶藏的守護神,地精,格言
gnomic=格言的,精闢的
goggle=護目鏡,睜眼看
gorgeous=美麗的,極好的
gormandize=拼命吃,貪吃
gosling=小鵝,年輕無知的人
governance=統治,支配
granary=穀倉,糧倉
granule=小粒,微粒
gratis=不付款的,免費的
greenhorn=初學者,容易受騙的人
gridiron=烤架,橄欖球場
grotesque=怪誕的,古怪的
growl=咆哮,吼叫
grudge=吝嗇,不滿
gruesome=令人毛骨悚然的,噁心的
gruff=粗野的
grumpy=脾氣暴躁的
gulch=深谷,峽谷
gull=海鷗,易上當的人,欺騙
gusto=愛好,興致勃勃
gutless=沒有勇氣​​的,怯懦的
guttle=狼吞虎咽
gynaecocracy=婦女當政
habitable=可居住的
haft=柄,把柄
haggard=憔悴的,消瘦的
haggle=討價還價
hamstring=切斷腿筋使成跛腿,使殘廢
hardbitten=不屈的,頑強的
hardihood=大膽,莽撞
hassle=激烈的辯論
hatchet=短柄小斧
hawker=沿街叫賣之小販
hawser=粗繩,大鋼索
hearsay=謠傳,道聽途說
heave=用力舉
hedgehog=刺猬
hedonic=享樂的,享樂主義學說
hedonism=享樂主義,享樂
heliotrope=向陽植物
helm=舵,駕駛盤
helot=奴隸,受人輕視之人
helve=斧柄
henpecked=順從妻子的,懼內的
hepatitis=肝炎
herald=傳令官,預示,先驅
herdsman=牧人
heyday=全盛時期,青春期
hilt=柄
hinterland=內地,窮鄉僻壤
hippopotamus=河馬
hoarse=嘶啞的,粗啞的
hobble=蹣跚,跛行
holcaust=大屠殺,浩劫
holograph=親筆信
homely=樸素的,不漂亮的
homily=說教,訓誡
homograph=同形異義字
horology=測時法,鐘錶製造術
horrendous=可怕的,令人恐懼的
howler=嚎叫的人或動物,滑稽可笑的錯誤
hubbub=嘈雜,喧嘩
huddle=擠成一堆,一對人
hunk=大塊
hut=簡陋的房子,棚
hygiene=衛生學,衛生
hypodermic=皮下注射的
icing=糖衣,糖霜
idol=神像,偶像
idolatrize=奉為偶像,盲目崇拜
idolize=將…當作偶像崇拜,極度喜愛或仰慕
illegible=難讀的,​​難認的
illiberal=氣量狹窄的
illustrious=著名的,顯赫的
imbecile=心智能力極低的人
immortal=不朽的,流芳百世的
impend=進行威脅,即將發生
imperil=使陷於危險中,危及
imprecation=祈求,詛咒
imputation=歸咎,歸罪
impute=歸咎於
incertitude=疑惑,不確定
incisor=門牙
incongruent=不協調的,不和諧的,不合適的
incorporeal=無實體的,非物質的,靈魂的
incrustation=硬殼,外層
indite=寫,賦
inebriate=使…醉,酒鬼,酒徒
ineffaceable=抹不掉的
ineligible=沒有資格的
inexpedient=不適當的,不明智的
inexpiable=不能補償的
infatuate=使迷戀,使糊塗
infatuated=迷戀的
infernal=地域的,可惡的
infliction=痛苦,刑法
informer=告發者,告密者
ingress=進入
insane=瘋狂的
insanity=瘋狂,愚昧
inscription=銘刻,題字
insolate=使暴晒
insouciance=漠不關心,漫不經心
installment=分期付款,安裝
insuperable=難以克服的
interdisciplinary=跨學科的
interlace=編織,交錯
interlocutor=對話者,談話者
interlope=干涉他人之事
interloper=闖入者
interstice=細裂縫,空隙
interweave=交織,編結
intestate=未留遺囑的
intestine=腸,內部的
intumescence=腫大,腫脹
investiture=任職儀式,授權儀式
invigilate=監考
invoice=發票,發貨清單,給開發票
iridescence=彩虹色
irradiate=使明亮,生輝
iterate=重做,反復重申
jamboree=快樂,喧鬧的集會
jape(at)=開玩笑或諷刺
jesting=滑稽的,愛開玩笑的
jitters=緊張不安
jolly=歡樂的,快樂的
jubilant=喜悅的,歡呼的
juncture=危機關頭,結合處
jurisprudence=法律學,法學
kaleidoscopic=千變萬化的
kiosk=售貨亭,電話亭
knoll=小山,小圓丘
laceration=撕裂,裂口
lackey=卑躬屈膝者,走卒
laggard=緩慢的,落後的,落後者
lamentable=令人惋惜的,悔恨的
laminate=切成薄板
lapidary=寶石工,寶石專家
latch=門閂,用門閂閂牢
layman=普通信徒,門外漢
layover=旅途中的短暫停留
lean=傾斜,斜靠,瘦骨嶙峋的
leash=繩子
leeward=順風的
leeway=餘地
legible=易讀的
lesion=傷口,損害
lexical=詞彙的,詞典的
lexicon=詞典
libelous=誹謗的
libido=性慾,生命力
licit=不禁止的,合法的
ligature=綁縛之物
limbo=不穩定,中間狀態
lineal=直系的,嫡系的
lineaments=特徵,輪廓
lingual=舌的,語言的
littoral=海岸的,海濱,沿海地區
livid=青灰色的,蒼白的,狂怒的
loam=沃土
locust=蝗蟲,貪吃的人
locution=語言風格,慣用語
loft=閣樓,頂樓
logjam=浮木阻塞,阻塞狀態,僵局
loiter=遊蕩,徘徊
lore=只是,傳說
lout=粗人
lowbred=粗野的,魯莽的
luricious=光滑的,好色的
lucre=錢,利益
lucubrate=刻苦攻讀,埋頭苦幹
lure=誘惑力,引誘
luscious=美味的,肉感的
lusty=精力充沛的
lynch=私刑處死
mackintosh=雨衣,防水膠布
maculate=有斑點的
maestro=藝術大師,音樂大師
magniloquent=誇張的
maim=使殘廢
makeshift=代用品,權宜之計
malediction=詛咒
malefactor=罪犯,作惡者
maleficent=有害的,犯罪的
malice=惡意,怨恨
malignant=惡毒的,充滿恨意的
mallet=木槌,大頭鎚
malodor=惡臭
manacle=手銬
maneuver=調遣,策略,操縱
mangy=患疥癬的,污穢的
maraud=搶劫,掠奪
mariner=水手,海員
marrow=骨髓,精華
matador=鬥牛士
matriarchy=母奴制,婦女統治
matriculate=錄取
maxim=格言,普遍真理
mayhem=嚴重傷害罪
medicate=用藥醫治,加入藥物
megalomania=自大狂
memento=紀念品
menial=僕人的,卑微的,家僕
mermaid=美人魚
mesmerism=催眠術,催眠狀態
mesmerize=對…催眠,迷住
metallurgy=冶金
miasma=瘴氣,不健康的環境或影響
midget=侏儒
mien=風采,態度
militant=好戰的,好暴力的
millennium=一千年,太平盛世
miraculous=奇蹟的,不可思議的
miscellany=混合物
missive=信件,公函
mistimed=不合時機的
mistral=寒冷乾燥的強風
molest=騷擾,干擾
monastery=男修道院,僧院
monograph=專題論文
monopolize=壟斷,獨占
monotone=單調的
monstrous=巨大的,可怕的
moody=喜怒無常的,脾氣壞的
moor=曠野地,荒野,使停泊
mope=抑鬱不樂,生悶氣,憂鬱的人,情緒低落
morass=沼澤地,困境,陷入困境
moron=極蠢之人,低能兒
motile=能動的,有自動力的
mottle=使成雜色
mountebank=江湖郎中,騙子
muddle=混亂,迷惑
muddy=多泥的,渾濁的,不純的
muggy=悶熱而潮濕的
mulct=罰金,處以罰金,詐取,詐騙
multifarious=多種的,各式各樣的
multitude=多數,大眾,平民
muniments=契據,房契
musty=發霉的,有黴臭的
mutilate=殘害,切斷
mutinous=叛變的,反抗的
mutton=羊肉
muzzy=頭腦糊塗的
naivety=天真,純樸,幼稚
nasal=鼻的,有鼻音的
natation=游泳,游泳術
naysayer=懷疑者,否定者
necessitous=貧困的,急需的
necropolis=大墓地,公墓
nectar=瓊漿玉液,花蜜
nemisis=報應,天罰
neonate=初生兒
nephritis=腎炎
nestle=舒適地安頓,依偎
nestling=尚未離巢的小鳥
nethermost=最低的,最下方的
niggard=吝嗇鬼
niggling=瑣碎的
nihilism=虛無主義,民粹主義
nimble=敏捷的,靈活的
nippers=鉗子,鑷子
nipping=尖酸的,刺骨的
nonesuch=無匹敵的人
nonpareil=無匹敵的
noose=繩套,絞索
notability=著名,顯著
nude=赤裸的,裸體者
numerology=數字命理學
numinous=莊嚴的,神聖的
numismatic=錢幣學的
nuptial=婚姻的,婚禮的
nymph=年輕女神,少女
oar=槳,劃
oatmeal=燕麥片
obelisk=方尖碑
oblation=宗教的供品,祭品
observance=遵守,奉行
obtrude=突出,強加
occidental=西方
ocular=眼睛的,視覺的
oddment=殘餘物,零頭
odoriferous=有氣味的
olfactory=嗅覺的
oligarch=寡頭政治執政者
omnivorous=雜食的,興趣雜的
onslaught=猛攻,猛襲
onus=義務,負擔
ooze=慢慢地流,滲出,逐漸消失
opiate=安眠藥,鴉片製劑
optimization=最優化
opus=巨著,音樂作品
oracular=神諭的,意義模糊的
orifice=小開口,小孔
orotund=洪亮的,誇張的
otiose=不必要的,多餘的
outfox=以機智勝過
oversight=疏忽,失察,勘漏
overweening=自負的,過於自信的
palaver=空談,奉承
paling=籬笆,木柵欄
pamper=縱容,過分關懷
pane=窗格玻璃
panoramic=全景的,全貌的,概論的
pantechnicon=家具倉庫,家具搬運車
pantheon=萬神殿
paralyze=使癱瘓,使無效
parley=和談,會談,和談,會談
parlous=靠不住的,危險的
parochial=教區的,地方性的,狹小的
parturition=生產,分娩
pastor=牧師,牧人
pathetic=引起憐憫的,令人難過的
pathos=感傷,哀婉,悲愴
pawn=典當,抵押,被利用的小人物
peaky=消瘦的,虛弱的
peculate=挪用
pecuniary=金錢的
peddle=兜售
peek=偷看
peep=瞥見,偷看,初現
peery=窺視的,好奇的,懷疑的
pelt=扔,毛皮
pendent=吊著的,懸掛的
penetration=穿透,洞察力
pension=養老金,退休金
pensive=沉思的,愁眉苦臉的
penumbra=半明半暗之處,邊緣部分
peptic=產生胃酶的,助消化的
percolate=過濾出,滲透
percussion=敲擊樂器
perigee=近地點
periphrastic=迂迴的,冗贅的
perishable=易腐敗的,易腐敗的東西
persnickety=勢利的,挑剔的
personage=名人,角色
perverse=不合適的,剛愎自用的,故意作對的
pervert=使墮落,誤用,歪曲
pesky=討厭的,煩人的
pettish=易怒的,使性子的
pharisaic=偽善,偽裝虔誠的
phial=小瓶
philology=語文學,文學語言學
phobia=恐懼症
phony=假的,偽造的
piazza=陽台,廣場
piebald=花斑的,斑駁的
piecemeal=一件一件的,零碎的
pier=橋墩,碼頭
pilfer=偷竊
pillage=搶劫,掠奪
pincers=鉗子,鑷子
piscatorial=捕魚的,漁民的
pitiless=無情的,冷酷的,無憐憫心的
pivot=樞軸,中心,旋轉
plank=厚木板,要點
plaza=廣場,集市
plebeian=平民,平民的
plenary=全權的,全體出席的
plentitude=充分
pleonastic=囉嗦的
pliers=鉗子
plump=頗胖的,豐滿的
poach=偷獵,竊取
poltroon=懦夫
polyandry=一妻多夫制
polyglot=通宵多種語言的
polymath=知識廣博者
pony=小型馬
porcine=豬的,似豬的
porridge=麥片粥
portable=輕便的,手提式的
portend=預兆,預示
positiveness=肯定,確信
posterior=較後的
postscript=附言,後記
potboiler=粗製濫造的文藝作品
prance=昂首闊步
prefigure=預示,預想
prehensile=能抓東西的,能纏繞東西的
prepoonderant=以重勝的,優勢的,壓倒性的
prepossessing=給人好感的
presentiment=預感,預覺
presumable=可能的,可假定的
pretence=虛偽,藉口
prevision=先見,預感
prick=小刺,刺痛,刺傷,戳穿
prickle=刺,棘,刺痛
prig=自命不凡者,道學先生
prissy=謹小慎微的,神經質的,為小事掛慮的
procreate=生育
procrustean=強求一致的
progenitor=祖先,始祖
prognosticate=預測,預示
proofread=校對
prorogue=休會,延期
protrude=突出,伸出
proverbially=無人不知地
psalm=讚美詩,聖詩
puberty=青春期
puffery=極力稱讚,誇大的廣告,吹捧
pullulate=繁殖,劇增
pulpit=講壇
pulsate=有規律地振動
pulsation=脈動,跳動,有節奏的鼓動
pummel=接連地打,打擊
purblind=愚鈍的,視力不佳的
purport=意義,涵義
purse=縮攏或撅起,錢包
putative=公認的,普遍認為的
putrefy=使腐爛
putrid=腐臭的
pygmy=矮人,侏儒
pyromania=縱火狂
quadruangle=四邊形
quadruped=四足獸
quagmire=沼澤地,困境
qualm=疑懼,緊張不安
queasy=令人噁心的,充滿疑慮的
queer=奇怪的,瘋狂的
query=質問,疑問,詢問
quintessence=完美的榜樣,精華
quip=俏皮話,妙語
racketeer=敲詐者,獲取不正當錢財的人
raillery=善意的嘲弄
rapscallion=流氓,惡棍
rasp=發出刺耳的聲音
ratify=批准
ravish=迷住,搶奪
rebarbative=令人討厭的,冒犯人的
reckon=推斷,估計,猜想,設想
recline=斜倚,躺臥
reconnoiter=偵察,勘察
reedy=長滿蘆葦的,高而尖的
regal=帝王的,華麗的
regent=攝政者
regiment=團,嚴格控制
reincarnate=使化身,轉生
rejoin=回答,答辯
rejoinder=回答
remission=寬恕,赦免
remit=免除,寬恕,匯款
remittance=匯款
remittent=間歇性的,忽好忽壞的
remonstrance=抗議,抱怨
remonstrate=抗議,規勸
remunerate=報酬,補償
renascent=再生的,復活的
rendition=表演,扮演,演奏,演唱
renunciate=放棄
repent=懊悔,後悔
replica=複製品
reportage=報導,報導的消息,報告文學
repository=貯藏室,倉庫
rescript=公告,法令,重抄
reshuffle=再洗牌,改組
restorative=恢復健康的
resurge=復活
retention=保留,保持
retentive=有記憶力的
reticulation=網目,網狀
retrenchment=節省,削減
retroactive=溯及既往的,有追溯效力的
reversion=返回,逆轉
revulsion=厭惡,憎惡,劇烈反應
rhapsody=讚美之詞,狂想曲
riffle=漣漪
riffraff=烏合之眾,群氓
rigmarole=冗長的廢話
rinse=以清水沖洗,漂洗
rip=撕裂,撕碎
roister=喝酒喧嘩
rollicking=歡鬧的
rosy=玫瑰色的,美好的,樂觀的,健康的
rote=死記硬背
rotund=圓胖的,洪亮的
roundabout=繞遠道的,轉彎抹角的
rout=大敗,潰敗
rove=流浪,漂泊
rowdy=吵鬧的,粗暴的
rubble=碎石,瓦礫
ruck=皺褶,普通群眾
rucksack=背包
ruddy=紅潤的,紅色的
rumble=發出低沉的隆隆聲音
ruminate=反芻,深思
rustle=發出輕而爽的聲音
rustler=偷牛賊
saccharine=嬌媚的,嬌滴滴的
sack=粗布袋,掠奪
sacrament=聖禮,聖事
sadistic=施虐狂的,性施虐狂的
safe=保險櫃,冷藏室,飯廚
saga=英雄故事,長篇小說
saliferous=含鹽的,產鹽的
sanatorium=療養院,休養所
sangfroid=沉著,臨危不懼
sanitary=衛生的,清潔的
sapling=樹苗,年輕人
sardonic=嘲笑的
satanic=窮凶極惡的
sated=厭膩的
scab=創口上所結的疤,痂
scabrous=粗糙的
scads=大量,巨額
scald=燙,用沸水消毒,燙傷
scamper=奔跑,快跑
scan=細查,細看,瀏覽,掃描,分析韻律
scar=傷痕,傷疤
scare=驚嚇,受驚,威嚇
scarp=懸崖,陡坡
scathe=損害,燒傷,焦炭,嚴厲批評
sceptical=懷疑的,不相信的
scintillate=閃爍,流露機智
scission=切斷,分離,分裂
scooter=滑行車,踏板車
scorching=酷熱的
scour=擦洗,擦亮,四處搜索
scramble=攀登,爭奪
scrape=刮擦,擦掉
screed=冗長的演說,長篇大論的文章
scrumptious=很可口的
scud=疾行,疾駛
scrutter=疾走
scuttle=舷窗,艙口蓋
seafaring=航海的,跟航海有關的
seclude=和別人隔離
sect=派系
sedition=煽動叛亂
seditious=煽動性的
self-abasement=自卑,自謙
self-absorbed=自戀的
self-assertion=堅持己見,自信
senile=年老的
sensitize=使某人或某事物敏感
sensual=肉慾的,淫蕩的
sententious=好說教的,簡要的
sentry=哨兵,步哨
sequacious=盲從的
sequela=後繼者,後遺症
sequestrate=扣押,沒收
serenade=夜曲
serendipity=善於發掘新奇事物的天賦
serfdom=農奴身份,農奴境遇
sermonize=說教,講道
serpentine=似蛇般繞曲的,蜿蜒的
shabby=破爛的,卑鄙的
shack=簡陋的小屋,棚屋
shanty=簡陋的小木屋
shawl=披肩
sheaf=一捆,一束
sheen=光輝,光澤
shibboleth=陳舊語句
shimmer=閃爍,微微發亮
shipwright=造船者
showy=俗豔的,炫耀的
shred=碎布,破布,些許,撕碎
shrivel=枯萎
shuffle=拖步走,支吾,洗牌
shuttle=穿梭移動,往返運送
sidesplitting=令人捧腹大笑的
sidle=側身而行
signatory=簽署者,簽署國
signature=簽名,簽字
simian=猿的,猴的,猴,類人猿
simile=明喻
sinister=不吉祥的,險惡的
sizzler=炎熱天氣,大熱天
skein=一束
skittish=輕浮的,輕佻的
skullduggery=舞弊
skunk=黃鼬,黃鼠狼,欺騙
skyrocket=陡升,猛漲
slapdash=馬虎地
slaver=流口水,奉承,口水
slay=殺,殘殺
sleazy=邋遢的,格調低下的
sledgy=雪橇
sledgehammer=長柄大錘
sleight=巧妙手法,巧計,靈巧
sling=投擲,扔,吊腕帶,吊索
slit=撕裂,裂縫
slobber=口水流口水,粗俗地表示
sloven=不修邊幅的人
slue=旋轉
slump=猛然落下,暴跌
smirch=玷污,污點
snappish=脾氣暴躁的
snapppy=精力充沛的,瀟灑的
snicker=竊笑,暗笑
snob=勢利小人
snuggle=挨近,依偎
sociable=好交際的,友好的,合群的
sojourn=逗留,寄居
somnolent=思睡的,催眠的
sonorous=洪亮的
souse=浸在水中,使濕透
spacious=廣闊的,寬敞的
spangle=金屬片,閃光
spasmodic=痙攣的,間歇性的
speleology=洞窟學
splashy=濺水的,炫耀顯眼的
spool=捲盤
spoor=足跡,臭跡
spout=噴出,滔滔不絕地講
sprawl=伸展手腳而臥
sprint=短距離全速奔跑
spunk=勇氣,膽量
spurn=拒絕,擯棄
squeamish=易受驚的,易噁心的
stab=刺傷,戳
stagger=蹣跚,搖晃
stagy=不自然的,演戲一般的
standstill=處於停頓狀態,中止
star-crossed=時運不濟的
stash=藏匿,隱藏
steeple=尖塔,尖閣
stoop=俯身,降低身份
stouthearted=剛毅的,大膽的
straggle=迷路,落伍,蔓延
strangulation=扼殺,勒死
studio=工作室,畫室,演播室
stun=使暈倒,使驚嚇,打暈
stupefy=茫然,嚇呆
stupendous=巨大的,大得驚人的
sublimate=昇華,淨化
subscribe=捐助,訂購
subsist=生存下去,繼續存在,維持生活
substratum=基礎,地基
subvention=補助金,津貼
sully=玷污,污染
sundry=各式各樣,各種的
superannuated=老邁的
superlative=最佳的
superstition=迷信,盲目恐懼
surveillance=監視,盯梢
swank=誇耀,炫耀
swarm=一群,一群
swarthy=黝黑的
swear=詛咒
swipe=猛擊
symposium=專題討論會
tack=大頭釘,圖釘
tarry=徘徊,耽擱
tattered=衣衫襤褸的,破舊的
tautological=用語重複的
teem=充滿,到處都是,下傾盆大雨
teetotal=滴酒不沾的
tendinous=腱的
tensile=張力的,可伸展的
thespian=戲劇的,演戲的
thorny=多刺的,痛苦的,困難的
thrall=奴隸,農奴
thrash=鞭打
thresh=打穀,脫粒
thrifty=節省的
throes=劇痛
throttle=掐脖子,扼殺,節流閥
timeworn=陳舊的,老朽的
tinge=染色,使帶氣息
tipple=酗酒
topsy-turvy=顛倒的,相反的,亂七八糟的,混亂的
torpedo=魚雷
torrid=酷熱的
torso=軀幹,軀幹像
torture=酷刑,折磨,對…施以酷刑
touching=引起同情的
touchstone=試金石,檢驗標準
tousle=弄亂
traduce=中傷,誹謗,背叛
trammel=束縛,妨礙,魚網
tramp=重步走,長途跋涉
transfuse=輸血,充滿
trawl=拖網,用拖網捕魚,搜羅
treachery=陰險,背叛
tread=踩踏,步履,車輪胎面
treasurer=司庫,財務員,出納員
trek=艱苦跋涉
tremulous=顫動的,不安的
trench=溝,壕溝
tresses=女人的長發
tribulation=苦難,災難
tributary=支流,進貢
trickery=欺騙,詭計
trident=三叉戟,三叉魚叉
trivia=瑣事,無價值之物
truant=逃避責任的,逃學者,逃避者
truism=自明之理,真理
trumpery=中看不中用的
tumid=腫起的,腫脹的
tundra=凍原,苔原
tutelage=監護,指導
twaddle=胡說八道,瞎扯
tycoon=有錢有勢的企業家,大亨
typhoon=颱風
ulcerate=潰爛,生惡瘡
ulterior=較晚的,較遠的,不可告人的
ultramundane=超俗,世界之外的
unbidden=未經邀請的
unbridled=放縱的
uncooperative=不願合作的
undisputable=無可爭辯的,毫無疑問的
undulate=波動,起伏
unexceptional=非例外的,普通的,平凡的
unilateral=單方面的
unison=齊奏,齊唱,一致的或協調的行動
upfront=坦率的
upstart=突然升官的人,暴發戶
upsurge=高漲
uptight=焦慮不安的
urchin=頑童
ursine=熊的,像熊的
utensil=工具,用具
uxorious=寵愛妻子的
vagabond=浪蕩子,流浪者,流浪的
valetudinarian=體弱的人,過分擔心生病的人
valor=勇武,英勇
vampire=吸血鬼
vanguard=前衛
vegetate=像植物般生活,無所事事
ventral=腹部的
verbatim=逐字的,照字面的
verge=邊緣
vermin=害蟲,寄生蟲
vernal=春季的,春季似的
versemonger=拙劣詩人,打油詩人
vesture=衣服,覆蓋物
viand=食品,食物
vicissitude=變化,變遷,榮枯,盛衰
villainous=邪惡的,額度的
vim=精力,活力
vindication=洗冤,證實
vinegared=酸的,尖刻的
virago=潑婦,好罵人或好支配人的女人
virile=有男子氣的,雄健的
visage=臉,面貌
visceral=內心深處的,內臟的
vitreous=玻璃的,玻璃狀的
vomit=嘔吐,嘔吐物,催吐劑
vulpine=狐狸般的,狡猾的
wade=涉水,跋涉
wail=哀號,痛哭
waive=放棄,推遲考慮
wallop=痛擊,猛打
wallow=在泥水中打滾,沉溺
wangle=用巧計或花言巧語獲得某事物
wanton=無節制的,放縱的,頑皮的
warble=腫起的,腫脹的
warden=看守人,管理員
waspish=易怒的,尖刻的
waylay=埋伏,伏擊
weird=古怪的,荒唐的
welsh=賴債不還,失信
whelm=用…覆蓋,淹沒
whelp=犬科的幼獸
whit=一點兒,少量
wig=假髮
wiggle=扭動,蠕動
windfall=風吹落的果實,意外的好運
winkle=緩慢而費力地把某人弄出
wiretap=竊聽
witch=巫婆,女巫
wizardry=魔術,熟練
wizen=凋謝的,枯萎的
wont=習慣,習俗
woodcut=木刻,木版畫
wraith=幽靈,骨瘦如柴的人
wrangle=爭吵,吵架
wrath=憤怒,大怒
wreak=發洩怒火,報仇
wreathe=盤繞,把…做成花環
wreckage=殘骸
xenophobia=仇外,排外
yaw=偏航
yeoman=自耕農,鄉下人
zesty=熱望的
