expiate=贖罪,補償
expiration=期滿,終止
expire=期滿,去世
explicate=詳細解說,闡明
explicit=清楚明確的,成熟的,成型的
exploit=剝削,開發利用,英勇行為,功績
explosive=炸藥,爆炸性的,使人衝動的
exponent=說明這,支持者,提倡者,指數
exponentially=指數地,迅速增長地
exposition=闡釋,博覽會
expository=說明的
expostulate=(對人或行為進行),爭論,抗議,告誡
exposure=暴露,顯露,曝光
expound=解釋,闡述
expressly=清楚地,特意地
expunge=刪除
expurgate=刪除,使純潔
exquisite=精緻的,近乎完美的
extant=現存的
extemporaneous=即席的,沒有準備的
extemporize=即席演說
extend=延展,延長,舒展(肢體)
extenuate=掩飾(罪行),減輕罪過
exterminate=消滅,滅絕
externalize=使表面化
extinct=絕種的,不存在的
extinguish=使…熄滅,使…不復存在
extirpation=根除,剷除
extol=讚美
extort=勒索,敲詐
extract=拔出,強索
extraneous=外來的,無關的
extrapolate=預測,推測
extravagance=奢侈,揮霍
extremist=極端主義者
extricable=可解救的,能脫險的,能擺脫的
extricate=擺脫,脫離,拯救,救出
extrovert=性格外向者
exuberance=愉快,茁壯
exuberant=充滿活力的,(植物)茂盛的
exude=使慢慢流出,四溢
exult=歡騰,喜悅
fabric=紡織品,結構
fabricate=捏造,製造
façade=建築物的正面,外表
facet=(寶石等的)小平面,琢面,側面,問題的一面
facetious=輕浮的,好開玩笑的
facile=容易做的,膚淺的
facilitate=使容易,促進
facilities=(使事情便利的)設備,工具
faction=派系,派系鬥爭
factorable=能分解成因子的
factotum=雜工,打雜
factual=真實的,事實的
faculty=全體教員,官能
fad=(流行一時的)狂熱,時尚
faddish=流行一時的,時尚
fade=褪色,消失,凋謝
falcon=獵鷹,隼
fallacious=欺騙的,謬誤的
fallacy=謬誤,錯誤
fallibility=易於出錯,出錯性
fallible=會犯錯的,易犯錯的
fallow=休耕地,(土地)休耕的
falsehood=謊言
falter=搖晃,蹣跚
familiarity=精通,親近,不拘禮義
famine=饑荒
famish=使飢餓
fanatic=狂熱者
fang=(蛇的毒牙)毒牙
fantasy=想像,幻想
farce=鬧劇,荒謬,胡鬧
farewell=再會,再見,辭行,告別
far-reaching=影響深遠的
fast=絕食,齋戒,很快地,緊緊地
fasten=固定某物
fastidious=難以取悅的,愛挑剔的
fastness=要塞,堡壘
fatal=致命的,災難性的
fathom=英噚(測水深單位約1.8公尺),徹底明白,了解
fatigue=疲乏,勞累
fatten=始長肥,使土壤肥沃
fatuity=愚蠢,愚昧
fatuous=愚昧而不自知的
faucet=水龍頭
fault=錯誤,斷層
faultfinder=喜歡挑剔的人,吹毛求疵者
favorable=有利的,贊成的
fawn=未滿周歲的小鹿
faze=使…狼狽,折磨
feasible=可行的,可能的
feat=功績,壯舉
feature=特色,特點,特徵
feckless=效率低的,不負責任的
fecundity=多產,富饒,繁殖力,生殖力
feeble=虛弱的
feign=假裝,偽裝
feigned=假裝的,不真誠的
feint=佯攻,佯擊
felicitous=適當的,得體的
fell=獸皮,砍伐,兇猛的,可怕的
felon=重罪犯
felony=重罪
feminist=女權運動者
fender=擋泥板,護舷的墊子
feral=兇猛的,野的,野生的
ferment=發酵,騷動
fern=羊齒植物,蕨
ferret=雪貂,搜尋,用雪貂獵取,狩獵
ferrous=含鐵的
fertile=多產的,肥沃的
fertilize=受精,授粉,施肥
fertilizer=肥料,化肥
fervid=炙熱的,熱情的
fervor=熱誠,熱心,熱情
fester=(指傷口)潰爛,化膿
festive=歡樂的
fetid=有惡臭的
fetter=腳鐐
fetus=胎兒
feud=宿願,不和
fiasco=大失敗,慘敗
fiat=命令
fickle=(愛情或友誼)易變的,不堅定的
fictitious=假的,虛構的
fidget=坐立不安,煩躁之人
fig=無花果,毫不理會,一點兒
figment=虛構的東西,虛構的事物
figurative=比喻的,借喻的
figurehead=名義領袖,魁儡
figurine=小塑像,小雕像
file=銼刀,銼平
filibuster=妨礙議事,阻饒
filigree=金銀絲做的工藝品
filings=銼屑
filly=小母馬
filter=濾紙,過濾
filth=骯髒,粗語,粗話
finale=最後,最終,樂曲最後的部份,終曲
finesse=技巧,計謀,手段
finicky=苛求的,過份講究的
finite=有限的
firearm=槍枝
firefly=螢火蟲
fiscal=國庫的
fissure=裂縫,裂隙
fixate=使固定,始不變,注視,凌視
flaccid=鬆弛的,軟弱的
flag=減弱,衰退,枯萎
flagging=下垂的,衰弱的
flaggy=枯萎的,鬆軟無力的
flail=連枷,打,打擊
flak=高射炮,指責,抨擊
flamboyant=艷麗的,炫耀的
flammable=易燃的
