riot=參與暴動
riotous=暴亂的,騷動的,喧鬧的
ripen=使成熟
ripple=起漣漪,細浪,漣漪
rite=宗教的儀式
ritual=儀式,例行慣例
rival=競爭者,對手
rivalry=競爭,對抗
rive=撕開,分裂
riven=撕裂的,分裂的
rivet=鉚釘,吸引,注意力
riveting=非常精彩的
rivulet=小溪,小河
robe=長袍,禮服
robust=健壯的
roe=魚卵
roil=煽動,攪混
rookie=新兵,新手
roster=值班表,花名冊
rostrum=講台,講壇
rotate=旋轉,轉動,輪流,交替
rotten=腐敗的,糟糕的
roughen=變得粗糙,變得不平的
royalty=版稅
rubicund=臉色,紅潤的
rudder=船舵,領導者
rudimentary=初步的,未充分發展的
rue=後悔,遺憾
ruffian=惡棍,歹徒,殘暴的
ruffle=弄皺,激怒,衣服的,皺邊,摺邊
ruminant=動物反芻的,沉思的
rumple=弄皺,弄亂
rung=梯子橫檔,梯級
runic=北歐古代文字的,神秘的
rupture=破裂,斷裂
rural=鄉村的
ruse=騙術,詭計
rustic=鄉村的,鄉土氣的
ruthlessness=無情,殘忍
sabotage=陰謀破壞,顛覆活動
saboteur=從事破壞活動者
saccharin=糖精
sacred=神聖的,莊嚴的
sacrifice=犧牲,宰牲祭神
sacrilege=褻瀆,冒犯神靈
sacrilegious=褻瀆神聖的
sadden=使傷心,使悲哀
saddle=鞍,馬鞍
safeguard=防範措施
sagacious=聰明的,睿智的
sage=智慧的,智者
saintly=聖徒似的,極為聖潔的
salient=顯著的,突出的
saliva=唾液,口水
salmon=大馬哈魚,鮭魚,鮮肉色
salubrious=有益健康的
salutary=有益的,有益健康的
salutation=招呼,致意,敬禮
salute=行舉手禮,向致意,行軍禮
salvage=從災難中,搶救,海上救助
salve=藥膏,減輕,緩和
sampler=刺繡花樣,取樣員
sanctify=使神聖
sanctimonious=假裝神聖的
sanction=批准,認可
sandal=涼鞋,拖鞋
sane=神志清楚的,明智的
sanguine=樂觀的
sanity=神志清楚
sap=樹液,活力,削弱,耗盡
sapient=有智慧的
sapphire=青色,藍寶石,天藍色的
sarcastic=諷刺的
sartorial=裁縫的,縫製的
sash=肩帶
sate=使心滿意足,使厭膩
satiated=充分滿足,厭倦的,生膩的
satire=諷刺,作品
satirize=諷刺
saturate=浸透,使充滿
saturnine=憂鬱的,陰沉的
saunter=閒逛,漫步
savage=兇猛的,野蠻的
savant=博學之士,大學士
savvy=有見識和精明能幹的
sawdust=鋸屑
scabbard=刀,劍,鞘
scad=許多,大量
scaffold=腳手架,鷹架,造房時搭的架子
scalding=滾燙的
scale=魚鱗
scalpel=外科手術刀,解剖刀
scandal=醜聞,惡意毀謗
scant=不足的,缺乏的
scarcity=不足,缺乏
scarf=圍巾,披肩
scathing=苛刻,嚴厲的
scatter=散開,驅離
scenario=劇本提綱
schematic=綱要的,圖解的
schematize=利用計畫,扼要表示
scheme=陰謀,作品等,體系,結構
schism=組織分裂
school=魚群
scion=嫩芽,子孫
scissor=剪刀
scoff=嘲笑,狼吞虎嚥,嘲笑,笑柄
scoop=小鏟,勺子,用勺子,取出,舀出
scope=眼界,範圍
scorch=烤焦燒焦
score=樂譜
scorn=輕蔑
scorpion=蠍子
scotch=鎮壓,粉碎
scourge=鞭笞,磨難,鞭笞,磨難
scowl=怒容,生氣地皺眉,怒視
scrap=小片,碎穴,廢棄
scrappy=碎片的,好鬥的
scrawl=潦草地寫,亂塗
screw=螺絲釘,螺旋,吝嗇鬼
screwdriver=螺絲起子
scribble=亂寫,亂塗
script=劇本,腳本
scripture=經文,聖典
scroll=卷軸,紙卷,畫卷
scrub=矮樹叢,身體矮小的人,用力擦洗
scruple=顧忌,遲疑,顧忌
scrutable=可以理解的
scrutinize=詳細檢查,細讀
scuff=拖著腳走
sculpt=雕刻
scurrilous=下流的
scurry=急跑,疾行
scurvy=卑鄙的,可鄙的
scythe=大鐮刀
seam=縫,接縫
seamy=骯髒的,惡劣的
sear=以烈火,燒灼
seasoned=有經驗的,訓練有素的
seasoning=調味品,佐料
secede=正式脫離或退出,組織
secrete=隱藏,分泌
secretive=守口如瓶的
secular=世俗,塵世的
secure=安全的,穩固的,固定,使安全
securities=證券
sedate=鎮靜的
sedative=藥物,鎮靜的,鎮靜劑
sedentary=久坐的
sediment=沉澱物,渣
sedulity=勤奮,勤勉
sedulous=聚精會神的,勤勉的
seedling=幼苗
seemly=得體的,適宜的
seep=液體等,滲漏
seethe=沸騰,洶湧
segment=部分
seine=拉網,圍網,大捕魚網
seismic=地震的
semblance=外貌,相似
seminal=有創意的
seminary=神學院
sensation=知覺,轟動的事
sensible=明智的,可感覺到的
sensitive=敏感的
sensitivity=敏感,靈敏性
sensitization=敏化
sentient=有知覺的,知悉的
sentiment=多愁善感,思想情感
sentinel=哨兵,衛兵
separate=使分開,不同的,獨自的
septic=受感染的,腐敗的
sepulchral=墳墓的,陰森的
sequential=連續的,一連串
sequester=是隱退,使隔離
seraphic=如天使般的,美麗的
sere=乾枯的,枯萎的
