unwitting=adj.無心的,不經意的
unwonted=adj.不尋常的,不習慣的
unworldly=adj.非世俗的,精神上的
upbraid=v.斥責,責罵
upgrade=v.提升,給,升級
upheaval=n.動亂,大變動
uphold=v.維護,支持
upright=adj.垂直的,正值的
uproar=n.喧鬧,騷動
uproarious=adj.騷動的,喧囂的,令人捧腹的
upstage=adj.驕傲的,高傲的
upswing=n.上升,增長
urgent=adj.迫切的,緊急的
usurp=v.篡奪,霸占
usury=n.放高利貸
utilitarian=adj.功利的,實利的
utilize=v.利用,使用
utopia=n.理想國,理想的完美境界
utopian=adj.烏托邦式的,夢想的
utter=adj.完全的,發出聲音
vaccinate=v.給...接種疫苗
vaccine=n.牛痘苗,疫苗
vacillate=v.游移不定,躊躇
vacuous=adj.發呆的,愚笨的
vagary=n.奇想,異想天開
vagrancy=n.游蕩,流浪
vagrant=adj.漂泊的,流浪漢,無賴
vague=adj.模糊的
vain=adj.自負的,徒勞的
valediction=n.告別演說,告別詞
valedictory=adj.告別的,離別的
valiant=adj.勇敢的,英勇的
validate=v.使生效
valorous=adj.勇敢的
valve=n.活門,閥門
vandalism=n.(對公物等)惡意破壞
vandalize=v.肆意破壞
vanilla=n.香草,香子蘭
vanity=n.虛榮,自負
vanquish=v.征服
vantage=n.優勢,有利地位
vapid=adj.索然無味的
vaporization=n.蒸發
vaporize=v.使蒸發
vaporous=adj.無實質的
variance=n.矛盾,不同
variegate=v.使多樣化
variegation=n.雜色,斑駁
varnish=n.清漆,亮光漆,途上清漆
vascular=adj.血管的,脈管的
vault=n.拱頂,地喾
veer=v.轉向,改變
vehicle=n.交通工具,傳播媒介
veil=n.面紗,遮蔽物,掩蔽物,以面紗掩蓋
velocity=n.速度,迅速
venal=adj.唯利是圖的,貪贓枉法的
vendetta=n.世仇,宿願
vendor=n.小販
veneer=n.鑲面板,外表
venerate=v.崇敬,敬仰
vengeance=.報仇,報復
vengeful=adj.報復的,復仇心裡的
venial=adj.輕微的,可原諒的
venom=n.毒液,惡毒痛恨
vent=v.n.發洩,開孔,孔,口
ventilate=v.使通風,透風
ventriloquist=n.口技表演者,會口技的人
veracious=adj.誠實的,說真話的
veracity=n.真實性,誠實
verbal=adj.口頭的,與言辭有關的
verbiage=n.囉嗦,冗長
verbose=adj.冗長的,囉嗦的
verdant=adj.青蔥的,翠綠的
verdict=n.判決,決定
verdigris=n.銅鏽,銅綠
verified=adj.檢驗的,核實的
verify=v.證明,證實
verisimilar=adj.好像真實的
veritable=adj.確實的,名副其實的
vernacular=n.本國語,地方語
versatile=adj.多才多藝的,多用途的
verse=n.詩歌
vertex=n.頂角,頂點
vertical=adj.垂直的
vertigo=n.眩暈
verve=n.神韻,生機
vessel=n.血管,容器,船隻
vestige=n.痕跡,遺跡
vestigial=adj.退化的
vestment=n.法衣,官服
veterinary=adj.獸醫的
veto=n.否決,禁止
vex=v.n.惱火
vexation=n.困擾,苦惱
viability=n.生存能力,存活力
viable=adj.可行的,能活下去的
viaduct=n.高架橋
vibrancy=n.生機勃勃,活潑
vibrant=adj.振動的,明快的,生機勃勃的
vibrate=v.顫動,振動
vicar=n.教區牧師
vicarious=adj.替代的,代理的
vicinity=n.附近,接近
vicious=adj.殘酷的,兇猛的,危險的,惡劣的
vicissitudinous=adj.有變化的,變遷的
victimize=v.使受害,迫害
vie=v.競爭
vigilant=adj.機警的,警惕的
vigorous=adj.精力旺盛的,健壯的
vile=adj.惡劣的,卑鄙的
vilify=v.辱罵,誹謗
vindicate=v.為…平反,證明…正確
vindictive=adj.報復性的
vintner=n.酒商
violate=v.違反,觸反
violet=adj.n.紫羅蘭色的,紫羅蘭
viral=adj.病毒性的
virtual=adj.實質上的,實際上的
virtuosity=n.精湛技巧,高超
virtuoso=n.演藝精湛的人
virtuous=adj.有美德的,自命清高的
virulent=adj.劇毒的,惡毒的
virus=adj.病毒性的
viscid=adj.黏性的
viscous=adj.黏的
visionary=adj.有遠見的,幻想的,空想家
vista=n.遠景,展望
vital=adj.極其重要的,充滿活力的
vitalize=adj.激發活力的
vitiate=v.削弱,損害
vitrify=v.使成玻璃
vitriolic=adj.苛薄的
vituperate=v.痛斥,辱罵
vituperative=adj.辱罵的
vivacious=adj.活潑的,快活的
vivid=adj.清晰的,鮮豔的,大膽的,活潑的,逼真的
vocalist=n.流行歌手,聲樂家
vocation=n.擅長,才能,工作,職業
vogue=n.時髦,時尚
void=adj.空的,缺乏的,空隙,空處,空虛感
volatile=adj.反覆無常的,揮發性
volition=n.決斷力,意志
volley=n.齊發,群射,齊發,群射,截擊
voluble=adj.健談的,易旋轉的
voluminous=adj.長篇的,多產的
voluptuous=adj.撩人的,沉溺於酒色的
voracious=adj.狼吞虎嚥的,貪婪的
voracity=n.貪婪
votary=n.崇拜者,熱心支持者
vouch=v.擔保,證明
vulgar=adj.無教養的
vulnerable=adj.易受攻擊的
vulture=n.禿鷲
vying=adj.競爭的
waddle=v.(鴨子等)搖搖擺擺地走
waffle=n.v.蛋奶烘餅;胡扯
waft=v.漂浮;飄蕩
wag=v.n.(狗尾巴等)擺動;詼諧幽默
wage=v.開始進行(戰爭,運動)
waggish=adj.詼諧的,滑稽的
walrus=n.海象
wan=adj.虛弱的;病態的
wanderlust=n.漫遊癖;旅遊熱
wane=v.減少;衰微
want=n.缺乏;需要
wardrobe=n.衣櫥
warehouse=n.倉庫;貨棧
warmonger=n.好戰者,戰爭販子
