instrumentalist=樂器演奏者
insular=島嶼的,心胸狹窄的
insulate=使絕緣
insulin=胰島素
insurgent=叛亂的,起事的
insurrection=造反叛亂
intact=完整的,未動過的,原封不動的
intangible=不可觸摸的,觸摸不到的
integral=構成整體所必需的
integrate=使成整體
integrity=正值,誠實
intellect=智力,思維能力
intellectual=智力的,理智的
intelligible=可了解的,清晰的
intensify=加劇
intent=專心的,渴望的
intentional=存心的,故意的
inter=埋葬
interaction=相互作用(影響)
intercede=說好話,代為求情
intercept=中途攔截,截取
intercessor=仲裁者,調停者
interchangeable=可互換的
interdict=禁止
interference=干涉,妨礙
interim=中間時期,過渡時期
interjection=插入語,感嘆詞
interlock=連鎖,連串
interlude=(活動間的)暫時休息
interminable=無盡頭的,無止盡的
intermingle=混合,參雜
intermission=暫停,間歇
intermittent=斷斷續續,間些的,週期的
intern=拘禁的
internecine=內鬨的,兩敗居傷的
interplay=相互影響
interpolate=插入
interpose=置於…之間
interregnum=無王時期,空位期
interrogate=審問,審訊
interrogative=疑問的
intersect=橫截,橫斷
intersperse=散步,點綴
intertwine=糾纏,纏,繞
intervene=干涉,介入
intimate=親密的
intimidate=恐嚇,脅迫
intoxicate=(使)沉醉,(使)欣喜若狂
intractable=倔強的,難管的,棘手的
intransigent=不妥協的
intrepid=無畏的,剛毅的
intricacy=錯綜,複雜,紛亂
intricate=複雜難懂的
intrigue=密謀,引起極大興趣
introspective=自省的
intuition=直覺,由直覺或知的知識,憑直覺感知的事
intuitive=直覺的
inundate=淹沒,氾濫
inured=習慣的
invade=侵犯,侵入
invective=猛烈抨擊,痛罵
inveigh=痛罵,抨擊
inveigle=誘騙,誘使
inventory=詳細目錄,存貨清單
inverse=相反的,倒轉的
invert=上下倒置
invertebrate=無脊椎的(動物)
investigate=調查
inveterate=積習已深的
invidious=惹人反感的,導致傷害和仇恨的,招人妒忌的
invigorating=使人有精神的,使人健壯的
inviolable=不可侵犯的,不可褻瀆的
invoke=祈求的,懇求,(法律的)實施生效
involuntary=無意的
invulnerable=無法傷害的
iodine=碘
iota=極小量,極少
irascible=易發怒的
irate=發怒的
ire=憤怒
iridescent=閃採光的,現暈光的
irk=使苦惱,厭煩
irksome=令人苦惱,討厭的
ironclad=裝鐵甲的,堅固的
ironic=挖苦的,出乎意料的
irony=反話,諷刺,出人意料的事情或情況
irradicable=不能根除的
irreconcilable=不能協調的,矛盾的
irredeemable=無法挽回的
irreducible=數,不能約的
irremediable=無法治癒的,無法糾正的
irrepressible=無法約束或阻止的,壓抑不住的
irrevocable=無法取消的
irrigate=灌溉,沖洗傷口
irritable=易怒的,易受刺激的
irritate=激怒,刺激
isolate=孤立,將…從其種群中隔離
issue=出來,流出,發給分發,(書刊的)期
isthmus=地狹
itinerant=巡迴的,流動的
itinerary=行程表,旅行路線
ivory=象牙,長牙
jabber=快而不清楚地說
jade=疲憊的老馬,驽馬,玉,翡翠
jaded=疲憊的,厭倦的
jagged=鋸齒狀的,不整齊的
jamb=門窗地側住,門窗邊框
jar=衝突,牴觸,震驚,發刺耳聲
jarring=聲音刺耳的
jaundice=偏見
jaunt=短程旅遊
jaunty=愉快的,滿足的
jazz=爵士樂,喧鬧
jealousy=猜忌,妒忌
jejune=空洞的,枯燥的,不成熟的
jerk=突然猛拉
jeopardize=危及,危害
jeopardy=危險
jettison=(船)向外拋棄東西,拋棄的貨物
jibe=與…一致,符合
jigsaw,puzzle=拼圖,拼圖遊戲
jingoism=沙文主義,侵略主義
jockey=騎師,用計謀獲取
jocular=滑稽的,詼諧的,嬉戲的
jocund=快樂的,高興的
jog=慢而平靜地前進
jolt=顛簸著移動
jot=摘要記錄,草草記下
jovial=愉快的
jubilation=歡快,歡慶
judicial=法庭的,法官的
judicious=有判斷力的
juggernaut=摧毀一切的強大力量
jumble=混雜參雜
