cumbersome=adj.笨重的
cumulus=n.積雲
cunning=adj.善於騙人的,狡詐的,靈巧的
cupidity=n.貪婪
curator=n.(博物館等的),館長
curb=n.路緣,(接到的)鑲邊石,馬勒,勒馬繩;v.控制
curdle=v.使凝結,變稠
curmudgeon=n.脾氣暴躁之人
curriculum=n.(全部的)課程
cursory=adj.粗略的,草率的
curt=adj.(言詞,行為)簡略而草率的,草率而無禮的
curtail=v.削減,縮短
cushion=n.坐墊,靠墊
custodian=n.管理員,監護人
custody=n.監管,保管
customary=adj.合乎習俗的
cuticle=n.表皮
cutlery=n.(刀,叉,匙等),餐具
cyclical=adj.循環的
cyclone=n.氣旋,颶風
cylinder=n.圓柱
cynic=n.犬儒主義者,憤世嫉俗者
cypress=n.柏樹
cytology=n.[生]細胞學
dabble=v.涉足,淺嘗
daft=adj.傻的,愚笨的
dagger=n.短劍,匕首
daguerreotype=n.(早期)銀版照相
dainty=n.(常用複數形),量少而為美的食物,精美的食物,教美的,挑剔的
dally=v.閒蕩,嬉戲
damp=v.減弱,抑制;adj.潮濕的
damped=adj.減震的,壓低(聲音)的
dampen=v.(使)潮濕,使沮喪,潑冷水
dandy=n.花花公子,好打扮的人
dapper=adj.整潔漂亮的,動作敏捷的
dappled=adj.有斑點的,斑駁的
daredevil=adj.n.膽大的(人),冒失的(人)
dart=n.飛鏢;v.急馳
daunt=v.使膽怯,使畏縮
dawdle=v.閒蕩,虛度
deaden=v.減低某物的力量或強度
deadlock=n.相持不下,僵局
deadpan=adj.n.無表情的(臉)
dealing=n.生意行為,商業往來
dearth=n.缺乏,短缺
debacle=n.解凍,崩潰
debark=v.下船,下飛機,下車,卸載
debase=v.貶低,貶損
debate=n.正式的辯論,討論
debilitate=v.使衰弱
debouch=v.流出,進入(開闊地區)
debrief=v.向…詢問情況,聽取彙報
debris=n.廢墟,殘骸
debunk=v.揭穿真相,暴露
debut=n.初次登台,初次露面
decadence=n.衰落,頹廢
deceit=n.欺騙,欺詐
decency=n.正派,端裝
deception=n.欺騙手段,詐欺
decibel=n.分貝,(音量的單位)
deciduous=adj.非永久的,短暫的,脫落的,每年落葉的
decimate=v.毀掉大部分,大量殺死
decipher=v.解開,(疑團)
declaim=v.高談闊論,慷慨地發表
declamation=n.雄辯,高調
decline=v.拒絕,變弱,變小,減少,消減,衰弱,衰退
decode=v.譯解,(密碼)
decompose=v.(使)腐爛
decomposition=n.分解,腐爛,崩潰
decorate=v.裝飾某事物
decorum=n.禮節,禮貌
decrepit=adj.衰老的,破舊的
decry=v.責難,貶低(價值),毀謗
dedication=n.對某事業或目的的忠誠,專心致力
deduce=v.演繹,推斷
deduct=v.減去,扣除,演繹
deductive=adj.推裡的,演繹的
deed=n.行為,(土地或建築物的)轉讓契約,證書
deface=v.損壞
default=v.n.拖債,未履行的責任,違約
defeatist=n.失敗主義者
defect=n.缺點,瑕疵,變節,脫黨
defendant=n.被告
defense=n.防禦,防護
defer=v.推延,拖延,聽從
deference=n.敬意,尊重
deferential=adj.順從的,恭順的
defiance=n.挑戰,違抗,反抗
deficiency=n.缺陷
deficit=n.不足,赤字
defile=v.弄汙,弄髒
definitive=adj.明確的,有權威的,最終的
deflated=adj.灰心喪氣的
deflect=v.偏離,轉向
defoliator=n.落葉劑
defraud=v.欺騙某人
deft=adj.靈巧的,熟練的
defuse=v.從(爆破裝置)中卸除引信,緩和緊張狀態或危急局面
defy=v.違抗,藐視
degradation=n.降低身分,降級,受辱
dehydrate=v.除去水分,脫水
deify=v.奉為神,崇拜
deign=v.屈尊,惠允(做某事)
dejected=adj.沮喪的,失望的
delectable=adj.賞心悅目的,令人愉快的,美味的
delegate=n.代表;v.委派…為代表,授權
deleterious=adj.(對身心)有害的,有毒的
deliberate=adj.深思熟慮的,故意的;v.慎重考慮
delicacy=n.細嫩,精緻,優雅
delicate=adj.嬌嫩的,精緻的,優美的
delimit=v.定界,劃界
delineate=v.描畫,描繪
delinquency=n.失職,過失
delinquent=adj.疏忽職務的
delirious=adj.精神錯亂的
delirium=n.精神錯亂
delta=n.三角洲
delude=v.欺騙,哄騙
deluge=n.大洪水,暴雨
delusion=n.欺騙,幻想
delve=v.深入探究,鑽研
demagogue=n.蠱惑民心的政客
demand=v.要求,苛求
demean=v.貶抑,降低
demise=n.死亡,財產轉讓
demography=n.人口統計,人口學
demolish=v.破壞,拆除
demolition=n.破壞,毀壞
demonstrate=v.證明,論證,示威
demonstrative=adj.證明性的,喜怒形於色的
demoralize=v.使士氣低落
demote=v.降級,降職
demotic=adj.民眾的,通俗的
demur=v.表示異議,反對
demystify=v.弄清楚
den=n.獸穴,窩
denigrate=v.汙蔑,誹謗
denizen=n.居民,外籍居民
denomination=n.命名,(長度,幣值的)單位
denote=v.表示,指示意義
denouement=n.(小說的)結尾,結局
denounce=v.指責
