calamity=大災禍,不幸之事
calcium=鈣
calculated=蓄意的,計畫好的
calculating=深謀遠慮的,算計的,精明的
calculus=微積分學,結石
caldron=大鍋
calibrate=量…口徑,校準
calipers=測鏡器,雙腳規
calligraphy=書法
callous=結硬塊的,無情的
callow=(鳥)未生羽毛的,(人)未成熟的
calorie=卡,卡路里
calumniate=誹謗,重傷
calumny=誹謗,重傷
cameo=浮雕寶石,生動刻畫,(演員)出演,客串表演
camouflage=掩飾,偽裝
campaign=戰役,競選活動
canary=金絲雀,女歌星
candid=直率的
candidacy=候選人的資格
candor=坦白,率直
cane=拐杖
canine=犬的,似犬的
canny=精明仔細的
canon=經典,真作
canonical=按照教規的,見於宗教經典的
canopy=蚊帳,華蓋
cant=斜坡,斜面,隱語,術語,黑話,使傾斜
cantankerous=脾氣壞的,好爭吵的
canto=(長詩的),篇
canvas=畫布
canvass=細查,拉選票
canyon=峽谷
cape=披肩,短斗篷,海角
capillary=毛細血管,微血管
capitulate=(有條件的),投降
caprice=奇思怪想,變化無常,任性
capricious=變化無常的,任性的
capsule=莢,膠囊
caption=標題
captious=吹毛求疵的
captivate=迷惑,吸引
capture=俘虜,俘獲,奪取或贏得,戰利品
carafe=玻璃瓶
carapace=(蟹或龜等的)甲殼
carbohydrate=碳水化合物
carcinogen=致癌物
cardinal=最重要的,紅衣主教
cardiologist=心臟病專家
caress=愛撫,撫摸,愛撫或撫摸某人
careworn=受憂鬱折磨的,飽經風霜的
cargo=(船,飛機等裝載的)貨物
caricature=諷刺畫,滑稽模仿
carnivorous=肉食動物的
carol=頌歌,讚美詩,歡唱
carouse=狂飲尋樂
carp=鯉魚,吹毛求疵
carpenter=木匠
carrion=腐肉
cartographer=繪製地圖者
carve=雕刻
cast=演員陣容,劇團,鑄造
caste=社會等級,等級
castigate=懲治,嚴責
casual=偶然的
casualty=傷亡事故,傷亡者
cataclysm=劇變,災難(常指大紅水或地震)
catalyst=催化劑,促使事情發展的因素
catastrophe=突如其來的大災難
categorical=無條件的,絕對的
cater=迎合,照料,提供餐飲及服務
caterpillar=毛毛蟲,蝴蝶的幼蟲
catharsis=宣洩,淨化
cathedral=總教堂,主教堂
catholic=普遍的,廣泛的
caucus=政黨高層會議
caustic=腐蝕性的,刻薄的
cauterize=燒灼(表皮組織)以消毒或止血
cavalier=騎士,武士
cavalry=騎兵部隊,裝甲部隊
caveat=警告,告誡
cavern=大洞穴
cavil=挑毛病,吹毛求疵
cavity=(牙齒等的)洞,腔
cavort=歡躍,雀躍
cede=割讓(土地權利),放棄
celebrated=有名的,知名的
celebrity=名聲,知名人士
celestial=天體的,天上的
cellar=地下室,酒窖
cello=大提琴
cement=水泥,黏著劑,黏合,鞏固
censor=審查,檢查(出版品)
census=人口統計
centaur=人頭馬怪物
centigrade=百分度的,攝氏溫度計的
centralization=集中,集權化
centurion=古羅馬的百人隊長
ceramic=陶瓷製品,陶器的
cereal=穀類,穀類食品
cerebral=大腦的,深思的
ceremonious=儀式隆重的
ceremony=典禮,儀式
certainty=確定的事
certification=證明
certitude=確定無疑,確信
cessation=中止,(短暫的)停止
cession=割讓,轉讓
chafe=擦熱,擦痛,激怒
chaff=穀殼,米糠
chagrin=失望,懊惱
chalice=大酒杯,聖餐杯
chameleon=變色龍,蜥蜴,善變之人
champion=冠軍,鬥士,擁護者,擁護
championship=冠軍地位,錦標賽
chancellor=大臣,總理,首席法官,大學校長
chandelier=枝行吊燈(燭台)
chant=聖歌,歌唱或背誦,吟詠
chaos=混亂
chapel=(附屬教堂或監獄等的),小教堂
char=燒焦,使…燃燒成焦炭
characteristic=有特色的,典型性的,與眾不同的特徵
characterization=描繪,刻畫
characterize=描繪或刻畫…的特色
charade=用動作等表演文字意義的字謎遊戲,比手畫腳的猜字謎遊戲
charisma=(大眾愛戴的)領袖特質
charity=仁慈,施捨
charlatan=江湖郎中,騙子
charm=魅力,咒語,咒符,吸引,迷住
charter=特權或豁免權
chary=小心的,謹慎的
chase=雕鏤,追捕
chasm=深淵,大溝,峽谷,大差別
chaste=貞潔的,樸實的
chastise=嚴厲懲罰,譴責
chauvinistic=沙文主義的,過份愛國主義的
check=使突然停止,阻止
chef=廚師,主廚
cherubic=(尤指孩子)胖乎乎而天真無邪的
chicanery=詭計,狡詐
chide=叱責,指責
chimera=神話動物,夢想,幻想
chip=薄片,碎片,集成電路片,晶片
chipmunk=花栗鼠(像松鼠的美洲小動物)
chisel=鑿子,鑿,欺騙
chivalrous=武士精神的,對女人彬彬有禮的
choice=上等的,精選的
choir=(教堂的)唱詩班
choke=(使)窒息,阻塞
choleric=易怒的,暴躁的
chord=和旋,和音
choreography=舞蹈的,舞蹈編排,編舞
chorus=合唱隊,歌舞團
