neologism=新字,新義
neophyte=初學者,新手
nepotism=裙帶關係
nerve=勇氣,鼓起勇氣
nettle=蕁麻,煩憂,激惱
neurology=神經學
neutralize=使無效,中和
neutron=中子
nexus=(看法等的)聯繫,連結
nib=鋼筆尖
nibble=一點點地咬,慢慢啃
nice=精密的
nick=小傷口,刻痕
nightmare=惡夢,可怕的事
nil=無,零
nip=小口啜飲
nitpick=挑剔,吹毛求疵
nocturnal=夜晚的,夜間發生的
noisome=惡臭的,令人不快的
nomad=流浪者,游牧部落的人
nomadic=游牧的
nominal=名義上的,有名無實的
nominate=提名,任命,指定
nonchalance=冷漠,缺少關懷,沉著
noncommittal=態度曖昧的,不承擔義務的,不許諾的
nonentity=不重要的人或事
nonflammable=不易燃的
nonplus=使窘困迷惑的,迷惑,窘困
nonporous=無孔的,不滲透的
nonradioactive=非放射性的
nonsensical=荒唐的,無意義的
nonthreatening=不威脅的
nonviable=無法生存的
norm=規範,準則
nostalgia=懷舊之情,思鄉病
nostrum=家傳秘方,江湖藥,萬靈丹
notable=明顯的,出眾的,重要的
notch=V字形刻痕的
notorious=臭名昭著的,惡名昭彰的
nourish=滋養,懷有(希望等)
nova=新星
novelty=新奇(的事物)
novice=生手,新手
noxious=有害的,有毒的
nuance=細微的差異
nubile=(女孩)到婚嫁年齡的,吸引人的,性感的
nucleate=使成核,有核的
nucleus=(原子)核
nudge=(用肘)輕觸,輕推
nugatory=無價值的,瑣碎的
nullify=使無效,取消
numb=麻木的
numerous=許多的,很多的
numismatist=錢幣學家,錢幣收藏家
nurture=撫育,給…營養物,教養,養育,營養
nutrient=滋養物質
nutrition=營養,營養學
oafishness=癡呆
oak=橡樹
oasis=綠洲
oath=誓言,咒罵
obdurate=固執的,頑固的
obedient=服從的,順從的
obeisance=鞠躬,敬禮
obese=極肥胖的
obfuscate=使困惑,使迷惑
obituary=訃聞,訃告
objection=厭惡,反對
objective=客觀的,目標
obligation=責任,債務,欠的人債
obligatory=強制性的,義務的
oblige=束縛,迫使,恩惠於…,師恩惠
obliging=懇切的,熱心助人的
oblique=間接的
obliterate=塗掉,擦掉
oblivious=遺忘的,疏密的
obloquy=大罵,斥罵
obnoxious=令人不愉快的,可僧的
obscure=難理解的,不清楚的,隱藏,使…模糊
obscurity=費解,不出名
obsequious=逢迎的,諂媚的
observatory=天文臺
obsess=迷住,使窘困,使煩擾
obsolete=廢棄的,過時的
obstacle=障礙,干擾
obstinacy=固執,倔強,頑固
obstinate=固執的,倔強的
obstreperous=吵鬧的,難管束的
obstruct=阻塞,截斷
obtainable=能得到的
obtuse=愚笨的,不銳利的
obverse=正面(的)
obviate=排除(困難),消除
obvious=明顯的,顯而易見的
occlude=使閉塞
occult=秘密的,不公開的
occupation=工作,職業,占領
occurrence=事件,發生
octogenarian=80至89歲的人
odds=機會,可能性
ode=長詩,頌歌
odious=可僧的,討厭的
odium=僧惡,反感
odometer=(汽車)里程表
odyssey=長途的冒險旅行
offbeat=不規則的,不平常的
offence=(英)得罪,錯事,過錯
offense=(美)得罪,錯事,過錯
offend=得罪,冒犯
offensive=令人不快的,得罪人的
offhand=事先無準備地(的),隨便地(的)
officious=愛發命令的,好忠告的,過度殷勤的
offish=冷淡的
off-key=走調的,不和諧的
offset=補償,抵銷
offspring=兒女,後代
offstage=台後(的),幕後(的)
ogle=送秋波,媚眼
ointment=油膏,軟膏
olfaction=嗅覺
oligarchy=寡頭政治
omelet=煎蛋捲
ominous=預兆的,不祥的
omit=省略,遺漏,疏忽
omnipotent=全能的,萬能的
omnipresent=無處不在的
omniscient=無所不知的,博識的
onerous=繁重的,麻煩的
onset=(壞情況)開始發作
opacity=不透明性,晦澀
opalescence=(不透明的)乳白光
opaque=不透明的,難懂的
operative=(計畫等)實施中的,生效的
operetta=小歌劇,輕歌劇
opine=想,以為
opinionated=固執己見的
opponent=對手,敵手
opportune=合適的,適當的
oppose=反對
oppress=壓迫,壓制
opprobrious=辱罵的,惡名聲的
optimism=樂觀主義的
optimist=樂觀主義者
optimum=最好的,最有利的
optional=可自由選擇的
opulent=富裕的,充足的
oracle=代神發布神諭的人
oration=正式演說,演講
oratorio=清唱劇(沒有舞台走位,道具的戲劇)
oratory=演講術
orchard=果園
orchestra=管弦樂隊
ordain=任命(神職),頒發命令
ordeal=嚴峻考驗,痛苦經驗
ordinance=法令,條例
ordnance=大炮,軍械
ore=礦,礦石
organism=生物,有機體
orient=確定方向,使熟悉情況,東方
original=最初的,原始的,有創意的
originality=創造性,獨特性
ornate=華美的,充滿裝飾的
ornithologist=鳥類學家,鳥類學者
ornithology=鳥類學
orthodontics=畸齒矯正學,齒科矯正術
orthodox=正統的
