affected=adj.不自然的,假裝的
affidavit=n.宣誓書
affiliate=v.加入,聯合
affinity=n.密切關係,吸引力
affirm=v.確認,肯定
affix=v.黏上,貼上,附上,(在末尾)添寫某事務
afflict=v.使痛苦,折磨
affluent=adj.富裕的,豐富的
affordable=adj.能夠支出的
affront=v.侮辱,冒犯
agenda=n.議程
agglomerate=v.凝聚,結塊
aggrandize=v.增大,擴張,吹捧
aggravate=v.加重,惡化
aggression=n.侵略,敵對的情緒或行為
aggressive=adj.好鬥的,進取的
aggressor=n.侵略者,攻擊者
aggrieve=v.使受委屈,使痛苦
agile=adj.敏捷的,靈活的
agitate=v.攪動,煽動,使不安,使焦慮
agnostic=adj.不可知論的,不可知論者
agog=adj.興奮的,渴望的
agony=n.極大的痛苦
agrarian=adj.土地的
agreeable=adj.令人喜悅的,宜人的,欣然同意的
agronomy=n.農學,農藝學
ail=v.生病
airborne=adj.空氣傳播的,空運的
airtight=adj.密閉的,密不透風的
alabaster=adj.雪白潤滑的
alacrity=n.樂意,欣然,敏捷,活潑
albeit=conj.儘管,雖然
alchemy=n.鍊金術
alcove=n.凹室
alert=adj.警惕的,機警的,警報
alias=n.化名,別名
alibi=n.某人當時不在犯罪現場的申辯或證明,不在場證明
alienate=v.疏遠,離間某人
align=v.將某物排列再一條直線上,排成一直線,與某人結盟
alimentary=adj.飲食的,營養的
alkali=n.鹼
allay=v.減輕,緩和
allege=v.(無證據),陳述,宣稱
allegiance=n.忠誠,護擁
allegory=n.寓言
allergic=adj.過敏的,對…討厭的
alleviate=v.緩和,減輕
allocate=v.配給,分配
allowance=n.津貼
allude=v.間接提到的,暗指
alluring=adj.吸引人的,迷人的
aloft=adv.在空中,在高處
aloof=adj.冷淡的,孤零的
alphabetical=adj.按字母表順序的,按字序的
alter=v.改變,更改
alternate=adj.輪流的,交替的,候選人替代性選擇
altruism=n.利他主義,無私
aluminum=n.鋁
amalgam=n.混合物
amalgamate=v.合併
amass=v.積聚
amateur=n.業餘愛好者
ambidextrous=adj.十分靈巧的
ambiguous=adj.含糊的
ambivalent=adj.(對人或物)有矛盾看法的
amble=v.n.漫步,緩行
ambush=v.n.埋伏,伏擊,突擊
ameliorate=v.改善,改良
amenable=adj.願服從的,順從的,通情達理的
amend=v.修正(通常向更好的方向)變化,改善
amenity=n.禮儀,使人感到舒適的事物,便利設施
amiable=adj.和藹的,親切的
amicable=adj.友好的
amity=n.(人或國之間),友好關係
amnesia=n.健忘症
amnesty=n.大赦,特赦
amorphous=adj.無定形的
amortize=v.分期償還
amphibian=n.兩棲動物,水陸兩用飛行器
ample=adj.充足的,豐富的
amplify=v.放大,詳述
amplitude=n.廣大,廣闊
amulet=n.護身符
amuse=v.使愉快,逗某人校
anachronistic=adj.時代錯誤的
anaerobic=adj.厭氧的,厭氧微生物
anagram=n.變形詞
analgesia=n.無痛覺,痛覺喪失
analgesic=n.鎮痛劑,止痛的
analogy=n.相似,類比
analyze=v.分析,分解
anarchy=n.無政府(狀態),政治上的混亂
anathema=n.被詛咒的人,宗教意似的詛咒,宗教上的詛咒
anatomical=adj.解剖學的
ancestor=n.祖先,祖宗
ancestry=n.家系,世系
anchor=v.穩固,固定
ancillary=adj.輔助的,助手
anecdote=n.短故事,軼事
anemia=n.貧血,貧血症
anguish=n.極大的痛苦
angular=adj.有角的,(指人)瘦削的
anhydrous=adj.無水的
animate=adj.活的,有生命的,賦予生命
animosity=n.憎惡,仇恨
animus=n.敵意,憎恨
annals=n.編年史
annexation=n.吞併,併吞,合併
annihilate=v.消滅
annotate=v.註解
announce=v.宣布,發表,通報…….的到來
annoy=v.惹惱,打攪,騷擾
annul=v.宣告無效,取消
anomaly=n.異常,反常,異常事物
anonymity=n.無名,匿名
anorexia=n.厭食症
antagonize=v.使對抗,與…對抗
Antarctic=adj.南極的
antecedent=n.前事,前輩,祖先
antediluvian=adj.史前的,陳舊的
antenna=n.觸角,天線
anterior=adj.較早的,以前的
anthem=n.聖歌,讚美歌,國歌
