dynamic=adj.動態的
astonishing=adj.令人驚訝的
astonish=vt.使…驚訝
astonishment=n.[U]驚訝
reality=n.[U,C]現實,事實
realization=n.[U]實現
realistic=adj.實際的
ambitious=adj.有野心的
ambition=n.[C,U]野心
progressive=adj.先進的
progress=n.[U]進步
dramatically=adv.急遽地
dramatic=adj.急遽的
exterior=n.[C]外部,外觀
artistic=adj.藝術的
twist=vt.扭轉
strand=n.[C](繩,線等的)股,縷,線
component=n.[C]零件,組成部分
afford=vt.負擔得起,買得起
affordable=adj.負擔得起的,買得起的
villa=n.[C]度假別墅
extra=adj.額外的
novel=adj.新奇的,與眾不同的
novelty=n.[C,U]新奇的事物,新穎
futuristic=adj.極新潮的,合於未來的
immobile=adj.不能動的,固定的
mobile=adj.可移動的
cement=n.[U]水泥;vt.鞏固,加強
core=n.[C]核心
intensive=adj.密集的
generate=vt.產生
generator=n.[C]發電機
solar=adj.(of the sun)太陽的
panel=n.[C]鑲板,嵌板
gigantic=adj.巨大的,龐大的
excess=adj.額外的,附加的;n.[C,U]過度,過量
excessive=adj.過度的,極度的
excessively=adv.過度地
revolutionary=adj.革命性的,徹底改革的
revolution=n.[C,U]革命
radically=adv.(to a great extent)非常地
radical=adj.極端的,激進的
estate=n.[C]一大片私有土地
dimension=n.[C]面,方面
from top to bottom=ph.從上到下
in motion=ph.運行中
on top of=ph.除了…以外
