dispute=n.爭論,糾紛;vt.爭論,爭執
launch=vt.使船下水;n.發起,發動
immortal=adj.長生不死的
mortal=adj.終將死亡的,終有一死的;n.凡人,普通人
quote=n.引述,引文;vt.引用,引述
kidnap=vt.綁架,劫持
declare=vt.宣告,宣布
declaration=n.宣告,聲明
passion=n.熱情,激情
passionate=adj.熱情的,熱愛的
jealous=adj.嫉妒的,妒忌的
jealousy=n.嫉妒,妒忌
mythology=n.神話
conflict=n.衝突,爭執;vi.衝突,牴觸
erupt=vi.(戰事或衝突等)突發,爆發
eruption=n.爆發
refuse=vi.拒絕
refusal=n.拒絕
judge=vi.擔任裁判,裁決;n.裁判,評審
judgement=n.判斷,判斷力
command=vt.命令,下令;n.命令
bribe=vt.收買,賄絡;n.賄絡
wisdom=n.智慧
eventually=adv.最後,最終
eventual=adj.最後的,最終的
fulfill=vt.履行,執行
fulfillment=n.履行,實現
ally=n.(戰爭中的)盟國,盟友;vt.與…結盟
alliance=n.結盟,聯盟
conquer=vt.占領,征服
conquest=n.占領,征服
cunning=adj.狡猾的,奸詐的
hollow=adj.中空的,空心的
haul=vt.(用力)拖,拉
feast=vi.盡情吃喝,飽餐;n.盛宴,宴會
rejoice=vi.歡欣鼓舞
attack=n.攻擊;vt.攻擊
burn down (sth.)=(被)燒毀(…)
second to none=不亞於,首屈一指
sow the seeds of sth.=播下…的種子,成為…的肇端
win the heart of someone=贏得…的心
break out=爆發,突然發生
cast a spell on someone=對…下咒,對…施魔法
go by=(時間)流逝
turn to ~=求助於…
thanks to ~=幸虧…,由於…
in the hands of someone=受…控制
