global=adj.全球的
globe=n.球體
novel=n.(長篇)小說
novelist=n.小說家
instead=adv.代替,反而
translation=n.翻譯,譯文
translate=v.翻譯
communication=n.溝通
communicate=v.溝通
billion=n.十億
population=n.人口(總數)
major=adj.主要的,較重大的
major=n.主修科目
major=v.主修
government=n.行政,統治
education=n.教育
educate=v.教育
hardly=adv.幾乎不,幾乎沒有
imagine=v.想像
imagination=n.想像力
main=adj.主要的,最重要的
media=n.媒體
international=adj.國際的
percent=n.百分比
percentage=n.百分比,百分率
information=n.資訊,資料
thus=adv.因此
connect=v.連接
connection=n. 連接
researcher=n.研究者
research=v.研究
research=n.研究
a means of=ph.一種…方式,手段
to some degree=ph.有點兒,在某種程度上
in fact=ph.事實上
for example=ph.例如,比方
