extremely=adv.極端地,非常地
extreme=adj.極端的
saying=n.格言,諺語
company=n.公司
circle=v.環行,繞圈
journey=n.旅行
culture=n.文化
cultural=a.文化的
allow=v..允許,准許
allowance=n.零用錢
indeed=adv.的確
cycling=n.騎自行車活動
cycle=v.騎自行車
cyclist=n.自行車騎士
transportation=n.運輸
transport=v.運輸,搬運
effort=n.努力
promote=v.提倡,促進
promotion=n.提倡,促銷
popularity=n.流行,受歡迎的現象
popular=adj.流行的,受歡迎的
leisure=n.休閒
activity=n.活動
active=adj.有活力的,活潑的
result=n.結果;v.發生,產生
seek=v..尋找,追求
producer=n.製造者,生產者
produce=v.製造,生產
product=n.產品
official=n.官員,高層幹部
satisfy=v.使滿意,使高興
satisfied=adj.滿意的
satisfying=adj.令人滿意的
protect=v.保護
protection=n.保護
environment=n.環境
environmental=adj.環境的
deserve=v.應受,應得
at the age of=ph.在…歲的時候
set up=ph.建立,創立
give up=ph.放棄
change over=ph.改變
believe in=ph.信仰,信奉
no wonder=ph.難怪
