courtyard=n.[C]庭院
fame=n.[U]名聲,聲譽
prove=vi.vt.證明是,原來是
occur=vi.發生
occurrence=n.[C]事件,發生
shut=vt.關上,關閉;adj.關上的
protective=adj.保護的
steel=n.[U]鋼
trusty=adj.可信的,可靠的
devastating=adj.破壞性極大的,毀滅性的
devastate=vt.破壞
devastation=n.[U]破壞,蹂躪
threaten=vt.vi.威脅
threat=n.[C]威脅
submerge=vt.淹沒
roughly=adv.大約,約略
rough=adj.粗略的,初步的
factor=n.[C]因素
subsidence=n.[U]下沉,(地層)下陷
subside=vi.下沉,消退
underneath=adv.在下面;prep.在…底下
ban=vt.禁止;n.[C]禁止,禁令
pose=vt.造成;vi.擺姿勢;n.[C]姿勢
onset=n.[C]開始
quantity=n.[C,U]量
polar=adj.極地的
consequent=adj.隨之發生的,後來的
consequence=n.[C]後果
severe=adj.嚴重的,劇烈的
disrupt=vt.使混亂,使中斷
disruption=n.[C,U]分裂,瓦解
disruptive=adj.擾亂的,分裂的
function=vi.運作,起作用;n.[C]功能
functional=adj.實用的,機能的
incredible=adj.令人難以置信的
unsustainable=adj.無法維持的,無法永續經營的
sustainable=adj.能維持的,永續的
theoretical=adj.理論的,假設的
institution=n.[C]機構
a double-edged sword=ph.雙刃劍
be no strangers to=ph.對…熟悉,對…不陌生
in turn=ph.接下來
