natural=adj.正常的,理所當然的
prefer=v.偏好,較喜歡
awkward=adj.笨拙的
scissors=n.剪刀
abnormal=adj.不正常的
normal=adj.正常的
disease=n.疾病
outstanding=adj.傑出的
cause=n.成因;v.導致,造成
unknown=adj.不知道的,無人知曉的
fortunately=adv.幸運地
fortunate=adj.幸運的
aware=adj.明暸的,察覺的
safety=n.安全
convenience=n.便利
design=n.設計;v.設計
designer=n.設計師
website=n.網站
keyboard=n.(電腦或鋼琴上的)鍵盤
pedal=n.(鋼琴的)踏板;v.用腳踩踏板
thoughtfulness=n.體貼,貼心
thoughtful=adj.體貼的
uniqueness=n.獨特性
unique=adj.獨特的,獨一無二的
greet=v.打招呼
hug=n.擁抱;v.擁抱
cheek=n.臉頰
bump=v.撞
reach out to=ph.接觸(人群)
have a hard time=ph.…有困難
think of=ph.想到
as for=ph.至於
