tour=n.旅行;vt.旅行
citizen=n.公民
travel=vt.旅行;n.旅行
various=adj.多樣的,各式各樣的
vary=vt.變化,使不同
variety=n.種類
guide=n.導遊,嚮導;vt.引導
please=vt.使高興,願意
tongue=n.舌頭
reflect=vt.反映
reflection=n.反映
climate=n.氣候
geography=n.地理
geographical=adj.地理的
tropical=adj.熱帶的
tropics=n.熱帶
sour=adj.酸的
spicy=adj.香辣的
spice=vt.添加香料;n.辛香料
plenty=n.足夠,許多
roasted=adj. 燒烤的
roast=vt.燒烤
tasty=adj.可口的,好吃的
fat=n.脂肪
source=n.來源
rot=vt.腐敗,腐爛
rotten=adj.腐爛的
wrinkle=vt.使起皺紋,起皺摺;n.皺紋
available=adj.可得到的,可取得的
unfamiliar=adj.不熟悉的
familiar=adj.熟悉的,親近的
sample=vt.試吃;n.樣品
unusual=adj.罕有的,不尋常的
usual=adj.通常的,平常的
such as=ph.像是...是...
take for example=ph.舉…為例,舉…來說
live on=ph.以…為主食
dig in=ph.大快朵頤,津津有味地吃
