elevator=n.電梯
annual=adj.一年一度的
building=n.建築物
invention=n.發明,發明物
invent=v.發明
inventor=n.發明家
practical=adj.實際的
skyscraper=n.摩天大樓
century=n.一世紀
power=v.以...為動力
powerful=adj.一年一度的
steam=n.蒸氣;v.蒸煮
electricity=n.電
electric=adj.電動的
electronic=adj.電子的
passenger=n.乘客
install=v.安裝
installation=n.安裝
story=n.樓層
spread=v.蔓延,擴散;n.蔓延,擴散
nowadays=adv.現今,時下
frustrating=adj.令人感到挫折的
frustrate=v.使(人)失望
exit=v.出去,離場;n.出口
concept=n.觀念,概念
limited=adj.有限的
limit=v.限制;n.限制
similar=adj.相似的
similarity=n.相似點
express=adj.快速的
worldwide=adj.全世界
rush hour=ph.交通尖峰時間
up to=ph.多達,高達
rather than=ph.並非,而不是
