ivory=n.[U]象牙色
gown=n.[C]禮服
flatter=vt.突顯,襯托
tone=n.[C]色調;vt.加強
overwhelm=vt.難以承受
overwhelming=adj.超越情感所能負荷的
reserved=adj.含蓄的
reserve=vt.預約,保留
reservation=n.[C]預訂,訂位,[U]保留,現制
sketch=vt.vi.速寫,素描;n.[C]速寫,素描
dismiss=vt.不理會,屏除
dismissal=n.[U]不理會,屏除
phase=n.[C]階段
eventually=adv.終於
eventual=adj.最終的,最後的
strive=vi.努力
convert=vt.Vi.改變(某物/信仰);n.改變信仰者
conversion=n.[C,U]轉變,轉換
basement=n.[C]地下室
realize=vt.實現
juggle=vt.忙於應付
juggler=n.[C]變戲法者
sew=vi.vt.縫紉
sewing=n.[U]縫紉
draft=vt.起草,擬稿
patience=n.[U]耐心
patient=adj.有耐心的
discouraged=adj.氣餒的
discourage=vt.使氣餒
discouragement=n.[C]令人氣餒的事物,[U]氣餒
director=n.[C]總監,導演
freshman=n.[C]新鮮人,大一學生
acquaint=vt.使熟悉,使熟識
acquaintance=n.[C]認識的人,泛泛之交
dedication=n.[U]奉獻,投入
dedicate=vt.奉獻,投入
brand=n.[C]品牌
perseverance=n.[U]毅力,堅忍不拔
persevere=vt.堅持到底
earn=vt.贏得
earnings=n.收入
reputation=n.[U,C]聲譽,名聲
reputable=adj.聲譽卓著的
show off=ph.突顯
catch one's attention=ph.吸引注意力
place emphasis on=ph.強調
work one's way up=ph.步步高升
thankful for=ph.感謝
