observer=n.[C]觀察者,觀察家
converse=vi.說話
assistance=n.[U]協助
assist=vi.vt.協助
assistant=n.[C]助理,助手
invariably=adv.總是
invariable=adj.不變的
dread=adj.可怕的,令人害怕的;vt.害怕,擔心
detach=vi.vt.分開,取下
detachable=adj.可分離的,活動式的
detached=adj.分離的
reluctant=adj.遲疑的,不情願的
reluctance=n.[U]遲疑,不情願
previously=adv.先前
previous=adj.先前的
diploma=n.[C]證書,文憑
hospitalize=vt.使…住院
procedure=n.[C]步驟
approximately=adv.大約
approximate=adj.大約的,接近準確的
blurt=vi.脫口而出
misconception=n.[C]迷思,誤解
limitation=n.[U,C]限制
regulation=n.[C,U]規定
regulate=vt.規定
handicapped=adj.殘障的
beneath=prep.在…下方
attach=vt.把…附在…
attachment=n.[C,U]附件,依附關係
attached=adj.附帶的
garage=n.[C]車庫
manager=n.[C]經理
manage=vi.vt.經營,管理
management=n.[U]經營,管理
manageable=adj.可控制的
disabled=adj.殘障的
disable=vt.使傷殘
disability=n.[C,U]殘疾,無能
be dependent on=ph.依賴,依靠
in the eyes of=ph.就…來看,從…觀點
at the top of one's lungs=ph.極大聲地
drive something home=ph.把…講清楚
turn down=ph.拒絕
because of=ph.因為
come upon=ph.偶遇
