comic strip=n.[C]連環漫畫
readership=n.[C]讀者人數
upright=adj.正直的
synonym=n.[C]同義字
synonymous=adj.同義的,和…相關的
prone=adj.易於,傾向於
approval=n.[U]同意,認可
approve=vt.vi.批准,贊同,允許
acceptance=n.[U]認同,接受,贊同
barber=n.[C]理髮師
timid=adj.膽小的,膽怯的
withdrawn=adj.內向的,沉默寡言的
withdraw=vt.vi.抽離,撤退
withdrawal=n.[C,U]提款,收回
failure=n.[U,C]失敗
childhood=n.[U,C]童年
nickname=n.[C]暱名,小名vt.給…取綽號
bounce=vi.vt.彈起,彈回
initial=adj.起初的
sink=vi.vt.下沉,使…下沉
prospective=adj.潛在的,預期的
prospect=n.[U,C]可能性,前景
illustration=n.[C]插畫
illustrate=vt.為…畫插畫
illustrator=n.[C]插畫家
constructive=adj.建設性的
criticism=n.[U]批評
criticize=vt.批評
critical=adj.批評的
blame=vt.責備
success=n.[U,C]成功
successful=adj.成功的
author=n.[C]作者
revenge=n.[U]報復,報仇
mound=n.[C]投手丘
pitch=vi.vt.投擲(棒球)
stubborn=adj.頑固的
persistence=n.[U]堅持
define=vt.定義
definition=n.[C]定義
go trick-or-treating=ph.玩不給糖就搗蛋
strike a chord with=ph.引起共鳴
make up one's mind=ph.決定
only to=ph.結果竟然
give credit to=ph.歸功於…
