beneficiary=n.[C]受益人
beneficial=adj.有益的
questionable=adj.可疑的
rock=vt.使震驚
vicious=adj.兇惡的
vice=n.[C,U]不道德(罪行,行為)
brutally=adv.兇殘地
brutal=adj.兇殘的
brute=n.[C]兇殘的人(尤指男人)
cane=n.[C]拐杖
weapon=n.[C]武器
alarm=vt.使焦慮不安,驚慌;n.[U]驚慌
apologize=vi.道歉
apology=n.[C,U]道歉
identical=adj.一模一樣的
mutua=adj.互相的
deteriorate=vi.惡化
disappearance=n.[U,C]消失
laboratory=n.[C]實驗室
desperation=n.[U]極焦慮,絕望
desperate=adj.絕望的
suicide=n.[U,C]自殺
suicidal=adj.自殺的
potion=n.[C]有魔力的飲料
evil=n.[U]邪惡;adj.邪惡的
namely=adv.也就是說
manner=n.[C](sing.)方式
constraint=n.[C]限制,約束
constrain=vt.限制,約束
constrained=adj.被迫的,勉強的
conscience=n.[U,C]良心,良知
revelation=n.[U]揭示,暴露
execution=n.[U,C](處)死刑,[U]執行
execute=vt.處死,執行
apprehend=vt.逮捕
apprehension=n.[U]逮捕
make out=ph.寫文件,填表格
breathe a sigh of relief=ph.鬆了一口氣,如釋重負
give a sigh of relief=ph.鬆了一口氣
pay a visit to=ph.拜訪…
