cherry=n.櫻桃樹
blossom=n.(果樹的)花;vi.開花
atmosphere=n.氣氛
breeze=n.微風
scatter=vt.vi.灑落,(使)四散
narrow=adj.狹窄的
alley=n.巷道
maple=n.楓樹
spiritual=adj.心靈上的,精神上的
spirit=n.心靈,精神
capital=n.首都,首府
historic=adj.歷史悠久的
historian=n.歷史學家
historical=adj.根據歷史的,史學的
shrine=n.神社,祠堂
temple=n.寺廟
imitate=vt.模仿
imitation=n.仿製品,模仿
skillful=adj.精湛的
arrangement=n.排列
arrange=vt.排列,整理
viewer=n.觀看者
view=vt.觀看
charm=n.護身符,符咒,[U]魅力,吸引力
cloth=n.[U]布料
clothing=n.[U]衣服
packet=n.小包
pack=vt.vi.打包
wood=n.木頭,木材
woods=n.樹林
wooden=adj.木製的
district=n.地區
attraction=n.吸引人的事物
musical=adj.音樂的
instrument=n.樂器
instrumental=adj.樂器的
present=n.[U]現在,現今;adj.現在的
graceful=adj.優雅的
grace=n.[U]優雅
capture=vt.擄獲(人心);n.[U]俘虜,被捕獲的人或物
leave behind=ph.留下
in the form of=ph.以…的形式
either or=ph.兩者擇一,不是…就是…
catch sight of=ph.瞥見,看到
on one's way to=ph.前往(某處)
on one's way from=ph.離開(某處)
