landmark=n.地標
indicate=v.指出,指示
indication=n.徵兆,指出
role=n.角色
melt=v.融化
nearby=adj.附近的;adv.附近地
stream=n.溪,流
flow=v.流,流動;n.流,流動
form=v.形成;n.形式,型態
system=n.系統
supply=v.供給,供應;n.供給,供應品
daily=adj.每天的,日常的;n.日報;adv.每日,天天
link=v.連結;n.連結
level=n.層,水平面
purpose=n.目的,用途
waste=v.浪費;n.浪費
admirable=adj.令人敬佩的,值得讚揚的
admire=v.敬佩,讚賞
admiration=n.敬佩,讚賞
slope=n.坡地;v.傾斜
trade=n.買賣;v.交易,買賣
square=n.廣場
ditch=n.排水溝,溝渠
direct=v.指向,導向;adj.直接的
direction=n.方向
cherish=v.珍惜,真愛
resource=n.資源
harmony=n.合諧,和睦
harmonious=adj.合諧的,和睦的
arrive in=ph.到達
come into view=ph.被看到,映入眼簾
be made up of=ph.由…組成
take part in=ph.參加
make the best use of=ph.儘量利用,妥善
