cuddle=v.依偎,親熟地摟住
lap=n.大腿,膝部上方
uncover=v.揭開,發現
crisp=adj.脆的
digitally=adv.以數位形式地
digital=adj.數位的
literary=adj.文學的,文藝的
literate=adj.能讀寫的,有文化修養的
literacy=n.讀寫的能力
scan=v.掃描,粗略地看
scanner=n.掃描器
text=n.文字檔(電腦用語),本文
favor=v.偏好;n.偏愛,恩惠
content=n.內容,目次
hardware=n.硬體
category=n.類別
categorize=v.分類
bookmark=v.標記,新增最愛(網路用語);n.書籤
boast=v.誇耀;n.吹噓,誇耀
solely=adv.只是
respect=v.尊敬,尊重;n.尊敬,尊重
respectable=adj.令人尊敬的
respectful=adj.懷有敬意的
antique=n.古董;adj.古老的,古董的
wrap=n.書的封皮,包裹物;v.包覆
binding=n.裝訂材料,書的封皮
bind=v.綁
margin=n.頁邊空白
sentiment=n.情感,感覺
sentimental=adj.情感上的,多愁善感的
contrary=n.相反的事物;adj.相反的
librarian=n.圖書館長
Congress=n.美國國會
immigrant=n.移民
immigrate=v.遷移,移入
thanks to=ph.因為,幸虧
take an interest in=ph.對…感興趣
a thing of the past=ph.過時的
all said and done=ph.說到底,歸根究底
of the opinion that=ph.相信,認為
