prayer=n.禱告詞
general=n.將軍
hero=n.英雄
heroine=n.女英雄
heroic=adj.英雄式的
graduate=vt.畢業;n.畢業生,畢業
assignment=n.任務或工作,功課
assign=v.分配,指派
commander=n.指揮官,司令官
command=v.命令
remarkable=adj.非凡的,卓越的
remark=v.評論,說;n.所說的話
battle=v.打仗;n.戰鬥
remain=vi.保持,保留
significant=adj.重大的
address=vt.寫信給…,向…說
defeat=n.失敗;vt.擊敗,打敗
humble=adj.謙卑的
humility=n.[U]謙遜,謙卑
gentle=adj.溫和的
victory=n.勝利
victorious=adj.獲勝的
foundation=n.基礎
found=vt.建造
path=n.路徑
comfort=n.[U]舒適,安逸;vt.安慰,安撫
stress=n.[U]壓力
stressed=adj.(人感到)很有壓力的,緊張的
stressful=adj.(事物)造成很大的壓力
challenge=n.挑戰;vt.挑戰
challenging=adj.有挑戰性的
goal=n.目標
master=vt.精通
humor=n.[U]幽默
humorous=adj.有趣的,幽默的
simplicity=n.[U]簡單
simplify=vt.簡化
wisdom=n.[U]智慧
dare=vi.感,膽敢
be born into=ph.出生在…家庭
follow in one's footsteps=ph.跟隨某人的腳步
take seriously=ph.認真地看待
in vain=ph.白費,徒勞
