mutual=adj.共同的,共有的
background=n.(家事,經歷等)背景
definitely=n.毫無疑問地,確定地
definite=adj.明確的,確定的
crucial=adj.極重要的,關鍵性的
file=n.(電腦上的)文件,檔案;vt.把…歸檔,存檔
virtual=adj.虛擬的,模擬的
clue=n.提示,線索
flesh=n.(人或動物的)肉
howl=vi.長嚎;n.長嚎聲
commit=vt.犯(罪或錯誤)
suicid=n.自殺
bully=vt.霸凌,脅迫;n.恃強凌弱之人,惡霸
meanwhile=adv.在此期間,同時
delete=vt.刪除
account=n.(網站,公司等的)帳號
switch=vt.轉換,轉變;n.改變,轉變
site=n.網站;vt.使坐落在
nasty=adj.惡毒的,令人不愉快的
remark=n.言論,評論;vt.評論,談論
remarkable=adj.非凡的,卓越的
abusive=adj.辱罵的,謾罵的
abuse=vt.辱罵,謾罵;n.辱罵,謾罵
torture=n.折磨,煎熬;vt.使受到折磨,使受煎熬
comment=vt.評論,表達意見;n.意見,評論
efficient=adj.有效率的
efficiency=n.效率
agent=n.特務,間諜
agency=n.經銷機構,代理機構
violate=vt.侵犯,攪擾
violation=n.違反,違背
lose touch (with ~)=(與…)失去聯繫
a great deal of something=大量的某物
engage in something=參加…,從事…
track down ~=(經長時間)追蹤到…
in the hope of doing something=懷著…的期望
bring someone to justice=將…繩之以法,把…緝捕歸案
take advantag of ~=利用…
after all=畢竟
