ill=adj.生病的,不舒服的
illness=n.疾病,病
drain=v.使流出;n.排水管
flat=adv.水平地;adj.平的
including=prep.包含在內
profession=n.職業,專業
professional=n.專業人士,專家;adj.職業的,專業的
military=adj.軍事的;n.軍隊,軍方
service=n.服務
serve=v.服務
servant=n.僕人
overlook=v.俯視;v.忽略,忽視
couple=n.一對(情侶或夫妻);n.幾個
stroll=v.散步;n.散步
distance=n.距離
distant=adj.遠方的,遠離的
description=n.描述,描寫
describe=v.描述,描寫
worsen=v.惡化
worse=adj.更糟,更差
roommate=n.室友
discover=v.發現
discovery=n.發現
peacefully=adv.平靜地
peace=v.和平
peaceful=adj.平靜的,安靜的
energy=n.活力,元氣,精力
energetic=adj.有活力的
lift=v.舉起,提起;n.提,舉,抬
brick=n.磚,磚塊
shocked=adj.感到震驚的
shock=v.使震驚
shocking=adj.令人感到震驚的
next to=ph.緊鄰,在……旁
on end=ph.連續地,不斷地
arm in arm=ph.臂挽著臂
pass away=ph.去世
call for=ph.找來,要求
as soon as=ph.一…就…
