blueprint=n.藍圖
influential=adj.有影響力的
civil=adj.公民的
preach=v.宣揚,傳教
racism=n.種族歧視
racial=adj.種族的
assassinate=v.暗殺,刺殺
assassination=n.刺殺
erect=v.豎立,直立
solid=adj.穩靠的,實在的
sound=adj.健全的
dignity=n.尊嚴
dignify=v.使尊貴
count=v.有重要意義,有價值
ultimate=adj.最重要的
principle=n.原則
excellence=n.優異
excel=v.表現優異,精通
excellent=adj.優異的,傑出的
endeavor=n.努力;v.努力
essayist=n.散文家
essay=n.散文
lecture=n.演講;v.演講
sermon=n.布道
beaten=adj.久經踐踏的
sociological=adj.社會學的
sociologist=n.社會學家
sociology=n.社會學
plight=n.苦境
lot=n.命運,生活狀況
sweeper=n.清潔工
sweep=v.打掃
metropolitan=adj.大都會的
opera=n.歌劇
heaven=n.天堂
pine=n.松樹
shrub=n.灌木
bush=n.灌木(叢)
justice=n.正義
justify=v.合理化
burn the midnight oil=ph.熬夜
drop out of school=ph.輟學
in spite of=ph.儘管,雖然
fall to one's lot to=ph.命中注定要做…,…成為某人的任務(或責任)
