April=n.四月
August=n.八月
Chinese New Year=n.中國新年,春節
date=n.日期
December=n.十二月
dream=n.夢,做夢
England=n.英國,英格蘭
February=n.二月
fourth=adj.第四(的)
ghost=n.鬼
guess=v.猜
happened=v.發生(過去式)
hopped=v.跳躍(過去式)
horse=n.馬
in the end=adv.最後,終於
January=n.一月
July=n.七月
June=n.六月
March=n.三月
middle=adj.中間(的)
nobody=n.無人
noticed=v.注意(過去式)
November=n.十一月
October=n.十月
on sale=adj.特價
postcard=n.明信片
ROC=n.中華民國
second=n.秒
September=n.九月
shopping=n.購物
shouted=v.大喊(過去式)
third=adj.第三(的)
travel=v.旅行
up and down=adj.上上下下
while=conj.當…的時候
