clay oven rolls=n.燒餅
fried bread stick=n.油條
fried leek dumplings=n.韭菜盒
boiled dumplings=n.水餃
steamed dumplings=n.蒸餃
steamed buns=n.饅頭
steamed sandwich=n.割包
rice and vegetable roll=n.飯糰
egg cakes=n.蛋餅
100-year egg=n.皮蛋
salted duck egg=n.鹹鴨蛋
soybean milk=n.豆漿
rice and peanut milk=n.米漿
rice porridge=n.稀飯
plain white rice=n.白飯
glutinous oil rice=n.油飯
glutinous rice=n.糯米飯
braised pork rice=n.滷肉飯
fried rice with egg=n.蛋炒飯
sweet potato congee=n.地瓜粥
wonton & noodles=n.餛飩麵
sliced noodles=n.刀削麵
spicy hot noodles=n.麻辣麵
sesame paste noodles=n.麻醬麵
duck with noodles=n.鴨肉麵
goose with noodles=n.鵝肉麵
eel noodles=n.鱔魚麵
seafood noodles=n.烏龍麵
oyster thin noodles=n.蚵仔麵線
flat noodles=n.板條
rice noodles=n.米粉
fried rice noodles=n.炒米粉
green bean noodle=n.冬粉
pork, pickled mustard green noodles=n.榨菜肉絲麵
fish ball soup=n.魚丸湯
meat ball soup=n.貢丸湯
egg and vegetable soup=n.蛋花湯
clams soup=n.蛤蜊湯
oyster soup=n.蚵仔湯
seaweed soup=n.紫菜湯
sweet and sour soup=n.酸辣湯
wonton soup=n.餛飩湯
pork intestine soup=n.豬腸湯
pork thick soup=n.肉羹湯
squid soup=n.花枝湯
squid thick soup=n.花枝羹
vegetarian gelatin=n.愛玉
tomatoes on sticks=n.糖葫蘆
longevity Peaches=n.長壽桃
glutinous rice sesame balls=n.芝麻球
hemp flowers=n.麻花
horse hooves=n.雙胞胎
mein mein ice=n.綿綿冰
oatmeal ice=n.麥角冰
sweet potato ice=n.地瓜冰
eight treasures ice=n.八寶冰
tofu pudding=n.豆花
red bean with milk ice=n.紅豆牛奶冰
sugar cane juice=n.甘蔗汁
plum juice=n.酸梅汁
star fruit juice=n.楊桃汁
herb juice=n.青草茶
oyster omelet=n.蚵仔煎
coffin toast=n.棺材板
stinky tofu=n.臭豆腐
oily bean curd=n.油豆腐
spicy hot bean curd=n.麻辣豆腐
tenpura=n.天婦羅
prawn cracker=n.蝦片
shrimp balls=n.蝦球
spring rolls=n.春捲
chicken rolls=n.雞捲
salty rice pudding=n.碗糕
rice tube pudding=n.筒仔米糕
red bean cake=n.紅豆糕
bean paste cake=n.綠豆糕
pigs blood cake=n.豬血糕
glutinous rice cakes=n.糯米糕
taro cake=n.芋頭糕
taiwanese Meatballs=n.肉圓
pyramid dumplings=n.水晶餃
rice-meat dumplings=n.肉丸
fried white radish patty=n.蘿蔔糕
dried tofu=n.豆干
angelica duck=n.當歸鴨
betel nut=n.檳榔
