abolish=v.廢除
adopt=v.接受,採用;收養
amateur=n.業餘者
arduous=adj.費力的
barren=adj.不毛的
carve=v.刻
coin=v.鑄造,編造
contrive=v.構想,設計
coy=adj.嬌羞的
decay=v.衰微,腐敗
descent=n.降落
disgust=v.使厭惡
elastic=adj.彈性的
enlist=v.入伍,徵募
eulogy=n.頌辭,頌揚
fake=n.贗品
foolproof=adj.極簡單的,安全無比的
gaunt=adj.骨瘦如柴的,憔悴的
harsh=adj.嚴厲的
imitate=v.模仿
inquisitive=adj.好奇的,好問的
insinuate=v.暗示
jurisdiction=n.管轄權,裁判權
latent=adj.潛在的,潛伏的
laud=v.褒獎,讚美
malleable=adj.順從的
millennium=n.一千年
murmur=v.楠楠低語
negligible=adj.不足取的,無關緊要的
obsess=v.迷戀,著魔
outing=n.遠足
paradoxical=adj.矛盾的
perspective=n.觀點
porcelain=n.瓷器
prodigal=adj.浪費的
quota=n.配額
rapture=n.狂喜
remnant=n.殘屑
reverse=v.倒轉;取消,廢棄
satirical=adj.諷刺的
seethe=v.沸騰
sentry=n.哨兵
shabby=adj.破舊的
sneak=v.溜走
squeeze=v.壓榨,緊握
tardy=adj.緩慢的
torment=v.使痛苦
vaporize=v.蒸發
warrant=n.令狀,授權書
zigzag=adj.鋸齒狀的,曲折的
