accelerate=v.加速
agenda=n.議程
anguish=n.痛苦
ascertain=v.確定
asset=n.有價值之物,有用之物
avaricious=adj.貪心的
benevolent=adj.仁慈的
buckle=v.扣住彎曲
characteristic=n.特徵,特色
commence=v.開始
confiscate=v.沒收,充公
copious=adj.豐富的,大量的
deflect=v.使偏斜,使偏離
deviate=v.脫離
disposition=n.氣質,性情配置
emancipation=n.解放
ephemeral=adj.短暫的
exalt=v.提高
feeble=adj.虛弱的
fortify=v.加強
glare=n.強光v.瞪視
henceforth=adv.從此以後
impeccable=adj.無瑕疵的,無過失的
inept=adj.笨拙的,無能的,不適當的
interfere=v.干擾
lethargic=adj.昏睡的
mendicant=n.乞丐
modify=v.修正,減緩
novice=n.初學者,新手
optical=adj.視覺的
overly=adv.過度地
pending=adj.未決定的,審理中的
pharmaceutical=n.藥
posterity=n.子孫,後代
prank=n.惡作劇
prompt=adj.及時的,立刻的;v.激勵,促使
recital=n.朗誦,獨奏會
reproduce=v.複製,繁殖
rigor=n.嚴厲
scope=n.範圍
shrub=n.灌木
sort=n.種類v.分類
stately=adj.莊嚴的
subsequent=adj.其後的
symbolize=v.象徵
temperate=adj.溫合的,節制的
transparent=adj.透明的
untenable=adj.難獲支持的,站不住腳的
verdict=n.裁決
whiskers=n.腮鬚
