acumen=n.明智
alleviate=v.使緩和
anomalous=adj.異常的,不規則的
appraise=v.評價
bizarre=adj.奇異的
boost=v.提升
brawl=v.爭吵
climax=n.頂點,高潮
comply=v.遵守,順從
constrict=v.限制,壓抑
crisp=adj.脆的
culpable=adj.有罪的,該受譴責的
denote=v.表示
discern=v.辨別
doctrine=n.教義
dribble=v.滴落
endeavor=n.盡力
escalate=v.升高,增強
exotic=adj.外來的,有異國風味的
extract=v.抽出
fidelity=n.忠實,逼真
fittingly=adv.合適地
frothy=adj.起泡沫的
grope=v.摸索
homogeneous=adj.同質的
hubbub=n.吵鬧聲
imbue=v.灌輸
improvise=v.即席而作
iniquity=n.邪惡
isolate=v.使孤立
memorandum=n.備忘錄,便條
muffle=v.覆蓋,降低(聲音)
orbit=n.軌道
peril=n.危險
pledge=n.保證
preserve=v.保存
protagonist=n.主角
reiterate=v.重申
respiration=n.呼吸
rustle=v.發出沙沙聲
sensational=adj.轟動的
slaughter=n.屠殺
spiral=adj.螺旋的
stimulate=v.刺激
swell=v.膨脹
thoroughfare=n.街道
trivial=adj.瑣碎的
utopia=n.烏托邦,理想國
vigorous=adj.充滿活力的
vow=n.誓約
