accomplice=n.共犯
agitate=v.激動,擾亂
antagonistic=adj.敵對的
assay=v.分析
aviator=n.飛行員
bereave=v.剝奪,喪失
burnish=v.磨亮,擦亮
chef=n.廚師
communal=adj.自治的,共有的
confront=v.面對
couch=v.表達;n.床,睡椅
currency=n.貨幣
dehydrate=v.使乾燥,脫水
diffidence=n.羞怯
disseminate=v.傳播,宣傳
duration=n.持續,期間
embody=v.具體化
equation=n.方程式,相等
excerpt=n.選錄
fervent=adj.熱烈的
fragile=adj.易碎的
gorge=n.峽谷;v.吞食
heyday=n.全盛時期
imperious=adj.高傲的
inaugurate=v.就職
infectious=adj.傳染的
literacy=n.能力,教養
mason=n.泥水匠
monitor=v.監視
omnipresent=adj.無所不在的
overtake=v.追上
philology=n.語言學
precipice=n.斷崖
predicament=n.困境
propagate=v.繁殖,傳播
recur=v.再發生
rescue=v.救援
rival=n.對手
scrub=v.擦洗
simultaneous=adj.同時的
sparse=adj.稀疏的,稀少的
staunch=adj.忠實的
subtle=adj.精巧的,淡的
synthetic=adj.人造的
tenor=n.主旨
treacherous=adj.危險的,不忠的
turbulent=adj.混亂的,狂暴的
unwonted=adj.不習慣的,不尋常的
vindicate=v.辯護
wince=v.畏縮
