adept=adj.熟練的
allocate=v.分配
appropriation=n.撥款
audible=adj.聽得見的
blemish=n.污點
bouquet=n.花束
breeze=n.微風
candid=adj.誠實的
comprise=v.包括
contaminate=v.污染
critique=n.評論
cumbersome=adj.累贅的,笨重的
dense=adj.密集的
disciple=n.弟子,門徒
dominant=adj.主要的
drought=n.乾旱
exodus=n.離去
expedite=v.加速
extricate=v.解救
forlorn=adj.寂寞的,絕望的
garish=adj.俗麗的,耀眼的
grouch=v.發牢騷
hub=n.中樞
humanitarian=adj.人到主義的,博愛的
humiliate=v.使羞愧
inert=adj.不活動的,惰性的
innate=adj.天生的
irate=adj.生氣的
itinerary=n.旅程
lucrative=adj.可獲利的
lukewarm=adj.不熱心的
merchandise=v.買賣,交易
mundane=adj.日常的
organic=adj.有機性的
perish=v.死亡,滅亡
permanent=adj.永久的,不變的
plight=n.苦境
precipitate=v.降落,凝結
prevalent=adj.盛行的
redeem=v.收回
resume=v.重新開始
sensuous=adj.感官的,感覺的,感官快樂的
splenetic=adj.容易發怒的
stoicism=n.堅忍
supersede=v.接替
surge=n.大浪
thrust=v.力推
truculent=adj.攻擊的
verdant=adj.翠綠的
vulnerable=adj.易受傷的
