abiding=adj.永久的,持續性的
admonish=v.勸告
amass=v.積聚,收集
archive=n.檔案,紀錄
banter=v.嘲弄
captivity=n.監禁
coherent=adj.一致的
conciliatory=adj.安撫的
contrast=n.差異,對照
dearth=n.缺乏
derivative=n.衍生之物
disdain=v.輕蔑
elapse=v.經過,消逝
enigma=n.謎
etiquette=n.禮節
faction=n.黨派
foliage=n.樹葉
gauge=v.測量
harass=v.侵擾
imbibe=v.吸入
indemnify=v.賠償
insert=v.插入
judicious=adj.明智的
lateral=adj.側面的
malign=v.誹謗;adj.有害的
migrate=v.移居
munificent=adj.慷慨的
negative=adj.否定的
obscure=adj.微暗的
outcry=n.叫喊
panorama=n.全景
persistent=adj.持續性的
poll=n.投票
probity=n.正直,廉潔
quixotic=adj.幻想的,不實際的
rankle=v.使心痛
reminiscence=n.回憶
reverence=n.尊敬
sapient=adj.有智慧的
severe=adj.嚴厲的
snarl=v.咆哮
squash=v.壓扁
strive=v.努力
surreptitious=adj.秘密的
tap=v.輕敲;n.龍頭
tyro=n.初學者,新手
ulterior=adj.隱密的
vapid=adj.無味的,無趣的
wanton=adj.放縱的,胡亂的
zenith=n.頂點
