aboriginal=adj.土著的
advent=n.來臨
ambivalence=n.矛盾
annals=n.年鑑
arid=adj.乾燥的
barrier=n.障礙
blasphemous=adj.褻瀆神祇的
cataclysm=n.大災禍
coincide=v.同時發生,符合,一致
concoct=v.創造,調和
controversy=n.爭論
deceptive=adj.欺騙的
designate=v.指派,命名
disillusion=v.使幻滅
elicit=v.引出
enmity=n.敵意
euphonious=adj.悅耳的
fallacious=adj.錯誤的
fluffy=adj.毛茸茸的
gelatinous=adj.膠狀的
hatch=v.孵
immense=adj.龐大的
indigenous=adj.本地的,天生的
inspect=v.調查
juvenile=adj.少年的,幼稚的
launch=v.發射
mallet=n.木槌
mimic=v.模仿
mushroom=v.急速發展
nibble=v.細咬
outlast=v.比...還久
paramount=adj.最高的,最重要的
perspire=v.流汗
portable=adj.可攜帶的,手提的
proficient=adj.熟練的
psyche=n.精神,靈魂
relegate=v.移管,委託;放逐
remote=adj.遙遠的
revert=v.恢復
scaly=adj.鱗狀的
shady=adj.陰暗的可疑的
snobbish=adj.勢利的
stag=n.雄鹿
suffuse=v.布滿
suspense=n.懸疑
tarnish=v.使晦暗
torrent=n.急流
undermine=v.破壞
variation=n.變化
wary=adj.小心的
