abandon=v.放棄
addict=v.使沈迷,使上癮
allure=v.吸引,引誘
approximately=adv.大約
baffle=v.使困惑
caliber=n.能力直徑,口徑
clot=n.凝塊
compromise=v.協調
contemporary=adj.當代的
dam=v.築水壩,以水壩攔阻
depict=v.描述
disclose=v.洩漏
eccentric=adj.古怪的
endowment=n.天分,捐贈
estate =n.地產,財產
fabric=n.質地結構
famine=n.飢荒
fusion=n.結合
haggard=adj.憔悴的
illiterate=adj.不識字的
inadvertent=adj.不注意的
innermost=adj.最深處的
jeopardy=n.危險
lace=v.繫(帶子)
lull=v.使平靜,使入睡
magnificence=n.壯麗
mercurial=adj.多變的,水銀的
nasty=adj.污穢的,令人不快的
obituary=n.訃聞
ornamentation=n.裝飾品
pacesetter=n.引導者
pernicious=adj.有害的,惡性的
plot=n.v.密謀,計畫
prey=n.獵物
quarantine=n.隔離
radiance=n.發光,閃爍
relevant=adj.有關的
retaliate=v.報復
sagacious=adj.睿智的
sentimental=adj.情感上的
slither=v.滑行
splice=v.接合
streamline=v.使有效率
surly=adj.粗暴的
taboo=n.禁忌
thwart=v.阻撓
ultimate=adj.最終的
vacant=adj.空的
waive=v.放棄
Xerox=v.影印
