above all=ph. 最重要的
all at once=ph. 突然
all day long=ph. 整天,全日
all of a sudden=ph. 突然
all right=ph. 沒關係,可以
all the same=ph. 同樣地,仍然,依然
as a matter of fact=ph. 事實上,其實
as a result=ph. 因此,結果
as for=ph. 至於,有關(置於句首)
as if=ph. 彷彿
as long as=ph. 如果,只要
as soon as=ph. 一…就…
as though=ph. 彷彿
as to=ph. 至於,有關
as usual=ph. 照常,仍然
as yet=ph. 到目前為止
at all=ph. 絲毫,極少
at first=ph. 起先
at last=ph. 最後,終於
at least=ph. 至少
at once=ph. 立刻
at stake=ph. 得失攸關,瀕於危險
at times=ph. 有時候
attend to=ph. 照顧
be cheated=ph. 受騙(被動)
be constant=ph. 依附,堅持,固守
be revenged on=ph. (~ sb.)報仇
beside oneself=ph. 發狂,忘形
beware of=ph. 當心,注意
beyond question=ph. 毫無疑問的
blow out=ph. 輪胎爆裂
bring back=ph. 從他處拿來
bump into=ph. 偶然遇到,無意中發現
burn the midnight oil=ph. 遲睡,熬夜
by heart=ph. 熟記
by oneself=ph. 靠自己,獨立
by the way=ph. 順便一提
can not but=ph. 不得不
cause a stir=ph. 引起軒然大波
cheat sb.=ph. 欺騙某人(主動)
come across=ph. 碰撞,不期而遇
come to=ph. 使復甦,使甦醒
come to one's aid=ph. 前來援助某人
come upon=ph. 偶然遇到,無意中發現
compare A to B=ph. 將A比喻為B
compare A with B=ph. 比較A與B
cool down=ph. 變冷靜
day after day=ph. 每天,一天又一天
day in, day out=ph. 每天,一天又一天,(同day after day)
deceive sb.=ph. 欺騙某人(主動)
depart for=ph. 動身,起程
do one's best=ph. 盡力(做…)
every now and then=ph. 偶爾,(同every so often)
every so often=ph. 偶爾
fill out=ph. 填寫
for a while=ph. 一會而
for good=ph. 永久,永遠
for the time being=ph. 目前,暫時
from then on=ph. 從那時起
generally speaking=ph. 大致上,大體上,就全體而論
get along=ph. 前進,進展
get off=ph. 下車(船,飛機)
give in=ph. 屈服,讓步
go to sea=ph. 做水手,航海
grow up=ph. 長大,成人
had better=ph. 最好
hand in=ph. 繳交
hand over=ph. 移交
happen to=ph. 發生
happen to meet=ph. 偶然遇到,無意中發現
have no choice but=ph. 不得不 ,忍不住,禁不住
have talent for=ph. 使…適合,有…的才能
head for=ph. 前往某地,(同bound for)
in a hurry=ph. 急忙,慌忙
in addition=ph. 此外,而且
in addition to=ph. 此外,而且,除…外
in favor of=ph. 贊成
in general=ph. 大致上,大體上,就全體而論
in no way=ph. 絶不,一點也不
in the long run=ph. 終於
in the past=ph. 在過去,向來
in time=ph. 及時
in vain=ph. 無效,徒然
inside out=ph. 翻轉
irregularly=ph. 斷斷續續地
It is not long before …=ph. 過了不久就…
It stands to reason=ph. (~ that 子句)顯然
keep up with=ph. 趕上,保持…一樣的速度
leave for=ph. 前往某地,(同bound for)
leave sth. alone=ph. 聽任,別管,避開
lessen in intensity=ph. 使强度減輕,調和
let alone=ph. 更不必說,遑論
little by little=ph. 漸漸地,慢慢地
make a long face=ph. 不高興
make faces at=ph. (~ sb.)對…扮鬼臉
make for=ph. 前往某地,(同bound for)
name…after=ph. 以…命名,以…取名
never mind=ph. 沒關係,不要緊
nine out of ten=ph. 十之八九,非常可能地
no longer=ph. 不再…
no matter=ph. 不論
now and then=ph. 斷斷續續地
off and on=ph. 斷斷續續地
on and off=ph. 斷斷續續地
on no account=ph. 決不
on purpose=ph. 故意,蓄意
on the alert=ph. 注意
on the way=ph. 在途中
on the whole=ph. 大致上,大體上,就全體而論
on time=ph. 準時
once and for all=ph. 斷然地(只此一次下不為例)
once in a while=ph. 偶爾
out of=ph. 沒有,出自
out of date=ph. 過時的
out of order=ph. 故障
out of question=ph. 毫無疑問的
over and over=ph. 反覆,再三地
over and over again=ph. 反覆,再三地
pass away=ph. 去世,死去
place upside down=ph. 翻轉,顛倒,移交
provided that=ph. 惟,如果,只要,(同as long as)
pull a face=ph. 扮鬼臉
pull a long face=ph. 不高興
put up with=ph. 容忍
quite a few=ph. 很多,不少
rain or shine=ph. 不論晴雨
revenge oneself on=ph. (~ sb.)報仇
right away=ph. 立刻
ring back=ph. 回電
ring off=ph. 掛斷電話
rob sb. of sth.=ph. 搶劫(某人)
rule out=ph. 排除,否絶
run across=ph. 碰撞,不期而遇
run into=ph. 偶然遇到,無意中發現
set out for=ph. 前往某地,(同bound for)
show-off=n. 自大的人
sit up=ph. 遲睡,熬夜
smaller and smaller=ph. 越來越小
so far=ph. 到目前為止
so long as=ph. 如果,只要
somehow or other=ph. 設法,藉某種方法,不知道為什麼
stand out against=ph. 某種事物襯托之下而顯得突出
start for=ph. 前往某地,(同bound for)
stick to=ph. 忠於
take back=ph. 從此處拿走
take care of=ph. 照顧
take leave of=ph. 離開,告別
take place=ph. 發生,產生
take pride in=ph. 以…為榮
take revenge on=ph. (~ sb.)報仇
take sb. in=ph. 欺騙某人
take up=ph. 佔據,耗費
talk…into=ph. 信服,勸服
ten to one=ph. 十之八九,非常可能地
to accomplish=ph. 實行,完成
to adhere to=ph. 依附,堅持,固守
to arrive at=ph. 到達
to ask for advice=ph. 請求忠告
to be about to=ph. 即將
to be all set to do=ph. (~ sth.)準備做某事
to be bound for somewhere=ph. 前往某地
to be bound to=ph. 必定,必然
to be cut out for=ph. 使…適合,有…的才能
to be deceived=ph. 受騙(被動)
to be designed for=ph. 使…適合,有…的才能
to be full of=ph. 充滿
to be hard of hearing=ph. 重聽
to be in charge of=ph. 管理,負責
to be in the way=ph. 妨礙,阻撓
to be mixed up=ph. 混淆,迷惑
to be obliged to=ph. 不得不
to be out of the question=ph. 不可能
to be outstanding=ph. 顯著,傑出,突出
to be over=ph. 結束,完畢
to be prominent=ph. 顯著,傑出,突出
to be taken in=ph. 受騙
to be tired out=ph. 非常疲倦
to be up to=ph. (~ sth.)計畫,圖謀,策劃
to be up to date=ph. 最新式的
to be used to=ph. 習慣於…,對…習慣
to be well off=ph. 富有的,小康的
to bear in mind=ph. 記住,(同keep in mind)
to beat about the bush=ph. 旁敲側擊,拐彎抹角
to become of=ph. 發生
to believe in=ph. 信仰,深信
to blow out=ph. 爆裂,吹熄(蠟燭),燒斷(保險絲)
to blow up=ph. 爆炸
to break down=ph. 拋錨
to break in=ph. 調整,適應 ,插嘴 , 闖入
to break off=ph. 終止,斷絕
to break out=ph. 爆發,突然發生(可置於句首或句中)
to bring back=ph. 退還
to bring out=ph. 生產,出示
to bring to=ph. 使復甦,使甦醒
to bring up=ph. 撫養,養育,教養
to build up=ph. 增加,加強
to burn down=ph. 燒毀
to burn out=ph. 燒斷
to burn up=ph. 燒光
to burst out crying=ph. 突然大哭
to burst out laughing=ph. 突然大笑
to call for=ph. 去取物,去找人
to call off=ph. 取消,宣告終止
to call on=ph. 拜訪某人
to call sb. down=ph. 責罵某人
to call up=ph. 打電話
to carry out=ph. 實行,完成
to catch cold=ph. 感冒
to catch fire=ph. 著火
to catch on=ph. 理解,明白
to change one's mind=ph. 改變主意
to check on=ph. 檢查,審查,調查
to check up=ph. 檢查,審查,調查
to check up on=ph. 檢查,審查,調查
to cheer up=ph. 使高興,振作起來
to come about=ph. 發生,產生
to come across=ph. 偶然遇到,無意中發現
to come from=ph. 出生於,來自於
to come to=ph. 清醒,恢復知覺
to come to an end=ph. 結束
to come true=ph. 實現
to count on=ph. 依賴
to cross out=ph. 刪除
to dissuade from=ph. 勸…不要…
to do one's best=ph.
to do sth. over=ph. 重做
to do without=ph. 免除,無需
to drop in on=ph. 偶訪
to drop out=ph. 離去,不參加
to drop sb. a line=ph. 寫封短信給…,留便條給…
to eat in=ph. 在家出飯
to eat out=ph. 到餐館吃飯
to fall in love with=ph. (~ sb.)愛上某人
to fall off=ph. 落下,減少
to fall through=ph. 失敗,不能實現
to feel like=ph. (~ Ving) 想要
to feel sorry for=ph. 同情
to figure out=ph. 算出,想出
to fill out=ph. 填寫
to find fault with=ph. 挑剔
to find out=ph. 了解,發現
to fool around=ph. 嬉戲,虛度光陰,遊手好閒,鬼混
to get alone with=ph. 相處融恰 ,進展順利
to get along with=ph. 與…和好相處
to get away=ph. 逃去,離去,逃脫
to get back=ph. 回來
to get better=ph. 變好
to get busy=ph. 忙碌
to get even with=ph. 報復,報仇
to get in=ph. 上公車(船,飛機)
to get in touch with=ph. 與…聯絡
to get lost=ph. 迷路,迷失
to get mixed up=ph. 混淆,迷惑
to get nervous=ph. 緊張
to get on=ph. 上公車(船,飛機)
to get one's own way=ph. 一意孤行
to get out of=ph. 下車(船,飛機)
to get over=ph. 恢復,克復
to get rid of=ph. 擺脫
to get set=ph. 弄
to get sick=ph. 生病
to get through=ph. 結束,完成
to get tired=ph. 疲倦
to get tired of=ph. 對…感到厭倦
to get to a place=ph. 到達某處
to get up=ph. 起床
to get used to=ph. 逐漸習慣
to get well=ph. 康復
to get worse=ph. 變壞
to give birth to=ph. 生,生產
to give in=ph. 屈服,投降,退讓
to give sb. a ring=ph. 打電話給某人
to give up=ph. 投降,放棄
to go around=ph. 夠用,夠分配
to go in for=ph. 愛好,嗜好,沉迷於
to go off=ph. 爆炸,離開
to go on=ph. 繼續
to go out=ph. 離開,熄滅
to go wrong=ph. 出毛病,發生故障
to grow out of=ph. 戒除,因長大而不合用
to hand in=ph. 繳交
to hang up=ph. 懸掛,掛斷
to have a good time=ph. 過得愉快
to have got to do=ph. (~ sth.)必須
to have it in for=ph. 憎恨,憎惡,伺機報復
to have it out with=ph. 與…起糾紛,和…攤牌,揭露真相
to have on=ph. 穿,戴(衣帽等)
to have one's heart set on=ph. 渴望,傾心於
to have one's own way=ph. 一意孤行
to have time off=ph. 有空
to have…on=ph. 穿著
to have…to do with=ph. 與…有關
to hear from=ph. 接到某人來信或消息
to hear of=ph. 有關…的消息
to hold out=ph. 繼續供應,足以維持,力足抵抗
to hold up=ph. 持槍搶劫,耽擱
to hurry up=ph. 趕快
to improve=ph. 變好
to keep an eye on=ph. 留意
to keep away from=ph. 遠離
to keep house=ph. 做家事
to keep in mind=ph. 記住
to keep in touch with=ph. 與…聯絡
to keep on=ph. 繼續
to keep out=ph. 遠離
to keep track of=ph. 追蹤
to keep up=ph. 保持同一速度或水準
to knock out=ph. 擊昏,擊倒
to know sb. by sight=ph. 曾經見過,面熟
to lay off=ph. 暫時解雇,資遣
to leave sth. out=ph. 漏掉,刪除
to let go of=ph. (~ sth.)釋放某物
to let on=ph. 洩露,透露
to let sth. alone=ph. 聽任,別管,避開
to let up=ph. 減弱,減少
to lie down=ph. 躺下
to live up to=ph. 遵從,達到
to look after=ph. 照顧
to look at=ph. 望著,注視
to look down upon=ph. 輕視,瞧不起,藐視
to look for=ph. 尋找,期盼
to look forward to=ph. 期待
to look into=ph. 調查
to look out=ph. 小心,注意
to look out upon=ph. 面對,俯視
to look over sth=ph. 檢查
to look up=ph. 查出
to look up to=ph. 敬佩 ,尊敬
to make believe=ph. 假裝
to make clear=ph. 解釋說明
to make faces=ph. 扮鬼臉
to make friends=ph. 交朋友
to make fun of=ph. (~ sb./sth.) 嘲笑
to make good=ph. 成功
to make good time=ph. 以高速駕車旅行
to make no difference=ph. 沒關係,沒什麼區別
to make out=ph. 做,成功,了解,準備,假裝
to make over=ph. 更新,修改
to make sense=ph. 有意義,合理的
to make sure=ph. 確定,務必
to make the best of=ph. 逆來順受
to make up one's mind=ph. 下決心,決意
to meet sb. half-way=ph. 妥協,讓步,遷就
to mix up=ph. 混淆,迷惑
to one's disappointment=ph. 令人失望的是…
to one's heart's content=ph. 盡興地,隨心所欲地
to one's pleasure=ph. 令人高興的是…
to one's relief=ph. 令人欣慰的是
to one's satisfaction=ph. 令人滿意的是…
to one's surprise=ph. 令人滿意的是…
to overturn=ph. 翻轉,顛倒,移交
to pay attention to=ph. 注意
to pick out=ph. 挑選
to pick up=ph. 拾起,購員,搭載某人(搭便車)
to play jokes on=ph. 戲弄,開玩笑
to play tricks on=ph. 戲弄,開玩笑
to point out=ph. 指出
to put an end to=ph. 結束,終止
to put away=ph. 拿開,貯存
to put off=ph. 延遲,延續
to put on=ph. 穿,戴(衣帽等)
to put out=ph. 熄滅
to put sth. into practice=ph. 實行,完成
to put up=ph. 蓋,建造
to put up with=ph. 容忍,忍受
to read over=ph. 匆匆越過,略為閱讀
to remove=ph. 脫去(衣帽)
to run away=ph. 不告而別,逃走
to run errands=ph. 跑腿,跑差事
to run out of=ph. 用完
to run over=ph. 輾過
to see about=ph. 照顧
to sell out=ph. 售完 ,清理
to serve one right=ph. 罪有應得,接受應得的處罰
to set fire to=ph. (~ sth.)放火,焚燒
to set forth=ph. 動身,啟程,提出
to set on fire=ph. 放火,焚燒
to set out=ph. 動身,起程
to shake hands=ph. 握手
to show off=ph. 買弄,炫燿
to show up=ph. 出現,露面
to shut off=ph. 關閉
to shut up=ph. 關閉,住嘴
to sit down=ph. 坐下
to slacken=ph. 減弱,減少
to stand a chance=ph. 有機會,有可能
to stand for=ph. 代表,象徵 ,容忍
to stand out=ph. 顯著,傑出,突出
to stay in=ph. 留在家裡
to stay out=ph. 不在家
to stay up=ph. 遲睡,熬夜
to stick out=ph. 伸出
to stick sb.=ph. 欺騙
to stick to=ph. 依附,堅持,固守
to stick up=ph. 豎立
to stir up=ph. 惹起,引起,鼓勵,激勵
to stop…from=ph. 使…不能,阻止…使免於
to take a look at=ph. 看一看
to take a walk=ph. 散步
to take advantage of=ph. 利用,佔(某人)便宜
to take after=ph. 與…相像
to take back=ph. 送回
to take care of=ph. 照顧 ,處理,應付 ,承擔(費用)
to take exercise=ph. 做運動
to take hold of=ph. 抓住
to take off=ph. 脫去(衣帽)
to take one's time=ph. 不急,慢慢來
to take out=ph. 取出,拔出,約某人外出
to take over=ph. 接管,接收,接辦
to take pains=ph. 費力,盡力,用心
to take part in=ph. 參與
to take pity on=ph. 憐恤
to take place=ph. 發生,舉行
to take sb. for=ph. 誤認,錯認
to take sth. for granted=ph. 認為…為理所當然
to take sth. into account=ph. 考慮
to take sth. up with sb.=ph. 著手處理,諮商
to take turns=ph. 輪流
to take up=ph. 攻讀
to take…by surprise=ph. 使…驚訝
to talk over=ph. 討論,商量
to telephone=ph. 打電話
to tell apart=ph. 辨別,辨認
to tell one from the other=ph. 辨別,辨認
to the effect that=ph. 大意是說…
to think of=ph. 想念,作…看法,對…認為
to think over=ph. 考慮,思索
to throw away=ph. 拋棄
to tolerate=ph. 容忍
to transfer to another=ph. 翻轉,顛倒,移交
to try on=ph. 試穿,試戴
to try out=ph. 試驗,試用
to turn a deaf ear to=ph. 不願聽,對…充耳不聞
to turn around=ph. 轉身
to turn down=ph. 减低速度,降低音量 / 光度,拒絕
to turn off=ph. 關閉電源
to turn on=ph. 打開電源
to turn out=ph. 結果變成
to turn out to be=ph. 結果成為
to turn over=ph. 翻轉,顛倒,移交
to wait for=ph. 等待
to wait on=ph. 侍候,招待
to wait up for=ph. 等候至深夜不睡
to wake up=ph. 醒來,喚醒
to watch out for=ph. 警戒,留意
to wear down=ph. 磨損,使疲倦虛弱
to wear out=ph. 磨損
to wear sb. out=ph. 精疲力竭
to wear sth. out=ph. 穿破
to work out=ph. 進展,設計,結果變成
turn against=ph. 反抗
turn in=ph. 繳交
turn into=ph. 變成
turn to=ph. 求助於,著手,開始 (工作) ,查閱
up to sb. to=ph. 由某人決定
upside down=ph. 倒置
used to=ph. 過去常常
what do you say to=ph. …如何
without fail=ph. 務必,一定地
work round the clock=ph. 遲睡,熬夜
would like to=ph. 想要
would rather=ph. 寧願
