classmate=同學
student=學生
parent=學生家長
teacher=老師
principal=校長
head teacher=主任
nurse=護士
school staffing=職員
janitor=工友
security guard=警衛
1st grader=一年級生
2nd grader=二年級生
3rd grader=三年級生
4th grader=四年級生
5th grader=五年級生
6th grader=六年級生
elementary school students=國小生
junior high school students=國中生
senior high school students=高中生
junior college student=專科生
college=大學生
principal's office=校長室
office of academic affairs=教務處
office of students affairs=訓導處
office of general affairs=總務處
counseling office=輔導室
library=圖書室
health center=健康中心
music classroom=音樂教室
computer classroom=電腦教室
English classroom=英語教室
science classroom=自然教室
sports equipment room=體育器材室
sports track=運動場
basketball court=籃球場
playground=遊樂場
swimming pool=游泳池
corridor=走廊
stairs=樓梯
elevator=電梯
bulletin board=公佈欄
bathroom=廁所
pen=筆
desk=書桌
chair=椅子
blackboard=黑板
chalk=粉筆
whiteboard=白板
television=電視
textbook=課本
map=地圖
stationary=文具
color paper=色紙
scissors=剪刀
glue=膠水
toys=玩具
workbook=作業簿
tape recorder=錄音機
table=會議桌
whiteboard marker=白板筆
the globe=地球儀
students' work=學生作品
story book=故事書
reading corner=閱讀角落
CD player=CD音響
librarian=圖書管理員
borrowing books=借書
returning books=還書
book title=書名
author=作者
publisher=出版社
book=圖書
magazine=雜誌期刊
news paper=報紙
poetry=詩歌
prose=散文
novel=小說
fiction=小說
science fiction=科幻小說
comic book=漫畫
biography=人物傳記
encyclopedia=百科全書
dictionary=字典
science=自然科學類
art=藝術類
history=歷史類
geography=地理類
language=語文類
electronic resources=線上電子資料庫
