arise=起來,上升
arose=arise的過去式;起來,上升
arisen=arise的過去分詞;起來,上升
awake=喚醒
awoke=awake的過去式或過去分詞;喚醒
awaked=awake的過去分詞;喚醒
be=正在…,是;(am,is,are,…)的原形
am=第一人稱單數現在式;正在…,是
is=第三人稱單數現在式;正在…,是
are=第二人稱單複數現在式,第一、三人稱複數現在式;正在…,是
was=be的單數過去式;正在…,是
were=be的複數過去式;正在…,是
been=be的過去分詞;正在…,是
bear=忍耐
bore=bear的過去式;忍耐
born=bear的過去分詞;生
borne=bear的過去分詞;忍耐
beat=打,擊敗;可用於現在式、過去式或過去分詞
beaten=beat的過去分詞;打,擊敗
become=變成;可用於現在式或過去分詞
became=become的過去式;變成
begin=開始
began=begin的過去式;開始
begun=begin的過去分詞;開始
behold=看,將…視為
beheld=behold的過去式或過去分詞;看,將…視為
bend=彎曲,屈服
bent=bend的過去式或過去分詞;彎曲,屈服
bended=bend的過去式或過去分詞;彎曲,屈服
bereave=剝奪
bereaved=bereave的過去式或過去分詞;剝奪
bereft=bereave的過去式或過去分詞;剝奪
beseech=懇求;可用於現在式、過去式或過去分詞
besought=beseech的過去式或過去分詞;懇求
beset=包圍;可用於現在式、過去式或過去分詞
bet=打賭;可用於現在式、過去式或過去分詞
betted=bet的過去式或過去分詞;打賭
bid=囑咐,出價;可用於現在式、過去式或過去分詞
bade=bid的過去式;囑咐,出價
bidden=bid的過去分詞;囑咐,出價
bide=居住
bode=bide的過去式;居住
bided=bide的過去式或過去分詞;居住
bind=縛,綁
bound=bind的過去式或過去分詞;縛,綁
bounden=bind的過去分詞;縛,綁
bite=咬
bit=bite的過去式或過去分詞;咬
bitten=bite的過去分詞;咬
bleed=流血
bled=bleed的過去式或過去分詞;流血
blend=混合,混雜
blended=blend的過去式或過去分詞;混合,混雜
blent=blend的過去式或過去分詞;混合,混雜
blow=吹
blew=blow的過去式;吹
blown=blow的過去分詞;吹
break=打破,破裂
broke=break的過去式;打破,破裂
broken=break的過去分詞;打破,破裂
breed=生育,飼養
bred=breed的過去式或過去分詞;生育,飼養
bring=帶來
brought=bring的過去式或過去分詞;帶來
broadcast=廣播;可用於現在式、過去式或過去分詞
broadcasted=broadcast的過去式或過去分詞;廣播
build=建造
built=build的過去式或過去分詞;建造
burn=燃燒
burned=burn的過去式或過去分詞;燃燒
burnt=burn的過去式或過去分詞;燃燒
burst=爆炸,突然發生;可用於現在式、過去式或過去分詞
buy=買
bought=buy的過去式或過去分詞;買
cast=投,擲;可用於現在式、過去式或過去分詞
catch=接住,趕上
caught=catch的過去式或過去分詞;接住,趕上
chide=責罵,咆哮
chid=chide的過去式或過去分詞;責罵,咆哮
chided=chide的過去式或過去分詞;責罵,咆哮
chidden=chide的過去分詞;責罵,咆哮
choose=選擇
chose=choose的過去式;選擇
chosen=choose的過去分詞;選擇
cleave=劈開,劈,執著
clove=cleave的過去式;劈開
clave=cleave的過去式;劈,執著
cleft=cleave的過去式或過去分詞;劈開
cleaved=cleave的過去式或過去分詞;劈開
cloven=cleave的過去分詞;劈開
cling=黏著,依附
clung=cling的過去式或過去分詞;黏著,依附
come=來;可用於現在式或過去分詞
came=come的過去式;來
cost=花費;可用於現在式、過去式或過去分詞
creep=躡手躡足地走,爬行
crept=creep的過去式或過去分詞;躡手躡足地走,爬行
cut=切;可用於現在式、過去式或過去分詞
deal=處理,發牌
dealt=deal的過去式或過去分詞;處理,發牌
dig=挖,發掘
dug=dig的過去式或過去分詞;挖,發掘
digged=dig的過去式或過去分詞;挖,發掘
do=做
does=做(第三人稱單數)
did=do或does的過去式;做
done=do或does的過去分詞;做
draw=畫,拖拉
drew=draw的過去式;畫,拖拉
drawn=draw的過去分詞;畫,拖拉
drink=喝
drank=drink的過去式;喝
drunk=drink的過去分詞;喝
drunken=drink的過去分詞;喝
drive=開車
drove=drive的過去式;開車
driven=drive的過去分詞;開車
dwell=居住
dwelt=dwell的過去式或過去分詞;居住
eat=吃
ate=eat的過去式;吃
eaten=eat的過去分詞;吃
fall=掉落
fell=fall的過去式;掉落
fallen=fall的過去分詞;掉落
feed=餵食
fed=feed的過去式或過去分詞;餵食
feel=感覺
felt=feel的過去式或過去分詞;感覺
fight=打架,與…作戰
fought=fight的過去式或過去分詞;打架,與…作戰
find=發現
found=find的過去式或過去分詞;發現
flee=逃走
fled=flee的過去式或過去分詞;逃走
fling=扔,擲
flung=fling的過去式或過去分詞;扔,擲
fly=飛
flew=fly的過去式;飛
fiown=fly的過去分詞;飛
forbear=節制
forbore=forbear的過去式;節制
forborne=forbear的過去分詞;節制
forbid=禁止
forbade=forbid的過去式;禁止
forbidden=forbid的過去分詞;禁止
forecast=預測,預知;可用於現在式、過去式或過去分詞
forecasted=forecast的過去式或過去分詞;預測,預知
forego=前行,居先
forewent=forego的過去式;前行,居先
forgone=forego的過去分詞;前行,居先
foreknow=預知
foreknew=foreknow的過去式;預知
forknown=foreknow的過去分詞;預知
foresee=預知,看穿
foresaw=foresee的過去式;預知,看穿
foreseen=foresee的過去分詞;預知,看穿
foretell=預言
foretold=foretell的過去式或過去分詞;預言
forget=忘記
forgot=forget的過去式或過去分詞;忘記
forgotten=forget的過去分詞;忘記
forgive=原諒
forgave=forgive的過去式;原諒
forgiven=forgive的過去分詞;原諒
forsake=拋棄,離開
forsook=forsake的過去式;拋棄,離開
forsaken=forsake的過去分詞;拋棄,離開
freeze=結冰,凍僵
froze=freeze的過去式;結冰,凍僵
frozen=freeze的過去分詞;結冰,凍僵
get=得到,捉住
got=get的過去式或過去分詞;得到,捉住
gotten=get的過去分詞;得到,捉住
give=給
gave=give的過去式;給
given=give的過去分詞;給
go=去
went=go的過去式;去
gone=go的過去分詞;去
grind=磨碎
ground=grind的過去式或過去分詞;磨碎
grow=生長,種植
grew=grow的過去式;生長,種植
grown=grow的過去分詞;生長,種植
hang=掛起;吊死
hung=hang的過去式或過去分詞;掛起
hanged=hang的過去式或過去分詞;吊死
hear=聽到
heard=hear的過去式或過去分詞;聽到
hide=躲藏
hid=hide的過去式或過去分詞;躲藏
hidden=hide的過去分詞;躲藏
hit=打擊;可用於現在式、過去式或過去分詞
hold=舉行,緊握
held=hold的過去式或過去分詞;舉行,緊握
holden=hold的過去分詞;舉行,緊握
hurt=傷害;可用於現在式、過去式或過去分詞
keep=保持
kept=keep的過去式或過去分詞;保持
knit=編織;可用於現在式、過去式或過去分詞
knitted=knit的過去式或過去分詞;編織
know=知道,認識
knew=know的過去式;知道,認識
known=know的過去分詞;知道,認識
lay=鋪,下蛋;lie的過去式,躺
laid=lay的過去式或過去分詞;鋪,下蛋
lead=引導
led=lead的過去式或過去分詞;引導
leave=離開
left=leave的過去式或過去分詞;離開
lend=借出
lent=lend的過去式或過去分詞;借出
let=讓;可用於現在式、過去式或過去分詞
lie=躺
lain=lie的過去分詞;躺
light=點(火);可用於現在式、過去式或過去分詞
lit=light的過去式或過去分詞;點(火)
lose=喪失
lost=lose的過去式或過去分詞;喪失
make=製作,讓
made=make的過去式或過去分詞;製作,讓
mean=意指
meant=mean的過去式或過去分詞;意指
meet=遇見
met=meet的過去式或過去分詞;遇見
mislead=誤導
misled=mislead的過去式或過去分詞;誤導
misread=讀錯;可用於現在式、過去式或過去分詞
misspell=拼錯
misspelled=misspell的過去式或過去分詞;拼錯
misspelt=misspell的過去式或過去分詞;拼錯
mistake=弄錯
mistook=mistake的過去式;弄錯
mistaken=mistake的過去分詞;弄錯
misunderstand=誤解
misunderstood=misunderstand的過去式或過去分詞;誤解
outbid=報價上戰勝;可用於現在式、過去式或過去分詞
outbade=outbid的過去式;報價上戰勝
outbidden=outbid的過去分詞;報價上戰勝
outdo=優於,搶先
outdid=outdo的過去式;優於,搶先
outdone=outdo的過去分詞;優於,搶先
outgo=優於,比…更快速
outwent=outgo的過去式;優於,比…更快速
outgone=outgo的過去分詞;優於,比…更快速
outgrow=比…生長更大或快
outgrew=outgrow的過去式;比…生長更大或快
outgrown=outgrow的過去分詞;比…生長更大或快
outrun=跑的更快,超越;可用於現在式或過去分詞
outran=outrun的過去式;跑的更快,超越
outsell=在推銷上勝過…
outsold=outsell的過去式或過去分詞;在推銷上勝過…
outshine=光亮強過…
outshone=outshine的過去式或過去分詞;光亮強過…
outspread=擴張,展開;可用於現在式、過去式或過去分詞
outwear=用舊,穿破
outwore=outwear的過去式;用舊,穿破
outworn=outwear的過去分詞;用舊,穿破
overcast=使沮喪,變多雲;可用於現在式、過去式或過去分詞
overcome=克服;可用於現在式或過去分詞
overcame=overcome的過去式;克服
overdo=過度,誇張
overdid=overdo的過去式;過度,誇張
overdone=overdo的過去分詞;過度,誇張
overdraw=過度,誇張
overdrew=overdraw的過去式;過度,誇張
overdrawn=overdraw的過去分詞;過度,誇張
overdrink=飲過量
overdrank=overdrink的過去式;飲過量
overdrunk=overdrink的過去分詞;飲過量
overeat=吃過量
overate=overeat的過去式;吃過量
overeaten=overeat的過去分詞;吃過量
overfeed=吃得太多
overfed=overfeed的過去式或過去分詞;吃得太多
overgrow=過度生長
overgrew=overgrow的過去式;過度生長
overgrown=overgrow的過去分詞;過度生長
overhang=懸於…之上,迫近
overhung=overhang的過去式或過去分詞;懸於…之上,迫近
overhear=無意中聽到
overheard=overhear的過去式或過去分詞;無意中聽到
overlay=覆蓋,鍍;overlie的過去式;躺在…上面
overlaid=overlay的過去式或過去分詞;覆蓋,鍍
overlie=躺在…上面
overlain=overlie的過去分詞;躺在…上面
overpay=報酬給予過多
overpaid=overpay的過去式或過去分詞;報酬給予過多
override=撤銷,踐踏
overrode=override的過去式;撤銷,踐踏
overridden=override的過去分詞;撤銷,踐踏
overrun=橫行於,氾濫;可用於現在式、過去式或過去分詞
oversee=監督,瞭望
oversaw=oversee的過去式;監督,瞭望
overseen=oversee的過去分詞;監督,瞭望
oversleep=睡過頭
overslept=oversleep的過去式或過去分詞;睡過頭
overspend=過度使用,花費過多
overspent=overspend的過去式或過去分詞;過度使用,花費過多
overspread=擴張,蔓延;可用於現在式、過去式或過去分詞
overtake=追上,壓倒
overtook=overtake的過去式;追上,壓倒
overtaken=overtake的過去分詞;追上,壓倒
overthrow=打倒,
overthrew=overthrow的過去式;打倒,
overthrown=overthrow的過去分詞;打倒,
pay=支付
paid=pay的過去式或過去分詞;支付
plead=為…辯護;可用於現在式、過去式或過去分詞
pleaded=plead的過去式或過去分詞;為…辯護
pled=plead的過去式或過去分詞;為…辯護
prepay=預付
prepaid=prepay的過去式或過去分詞;預付
prove=證明
proved=prove的過去式或過去分詞;證明
proven=prove的過去分詞;證明
put=放;可用於現在式、過去式或過去分詞
quit=停止;可用於現在式、過去式或過去分詞
read=讀;可用於現在式、過去式或過去分詞
rebuild=重建,改建
rebuilt=rebuild的過去式或過去分詞;重建,改建
recast=重新計算;可用於現在式、過去式或過去分詞
relay=供給新材料;可用於現在式、過去式或過去分詞
rend=割裂,爆開
rent=rend的過去式或過去分詞;割裂,爆開
repay=還錢,償還
repaid=repay的過去式或過去分詞;還錢,償還
reread=重讀;可用於現在式、過去式或過去分詞
resell=再賣,轉售重換
resold=resell的過去式或過去分詞;再賣,轉售重換
reset=重換;可用於現在式、過去式或過去分詞
retell=重複
retold=retell的過去式或過去分詞;重複
rid=使免除;可用於現在式、過去式或過去分詞 
ride=騎
rode=ride的過去式;騎
ridden=ride的過去分詞;騎
ring=響(鈴)
rang=ring的過去式;響(鈴)
rung=ring的過去分詞;響(鈴)
rise=上升(太陽),起床
rose=rise的過去式;上升(太陽),起床
risen=rise的過去分詞;上升(太陽),起床
run=跑;可用於現在式或過去分詞
ran =run的過去式;跑
saw=鋸開;see(看)的過去式
sawed=saw的過去式或過去分詞;鋸開
sawn=saw的過去分詞;鋸開
say=說
said=say的過去式或過去分詞;說
see=看
seen=see的過去分詞;看
seek=尋找
sought=seek的過去式或過去分詞;尋找
sell=賣
sold=sell的過去式或過去分詞;賣
send=送;可用於現在式、過去式或過去分詞
set=設定,放置;可用於現在式、過去式或過去分詞
sew=縫合
sewed=sew的過去式或過去分詞;縫合
sewn=sew的過去分詞;縫合
shake=搖動
shook=shake的過去式;搖動
shaken=shake的過去分詞;搖動
shave=刮(鬍子等)
shaved=shave的過去式或過去分詞;刮(鬍子等)
shaven=shave的過去分詞;刮(鬍子等)
shed=流出,散發;可用於現在式、過去式或過去分詞
shine=照耀,發亮
shone=shine的過去式或過去分詞;照耀,發亮
shoot=發射
shot=shoot的過去式或過去分詞;發射
sit=坐
sat=sit的過去式或過去分詞;坐
slay=殺死
slew=slay的過去式;殺死
slain=slay的過去分詞;殺死
sleep=睡覺
slept=sleep的過去式或過去分詞;睡覺
slide=滑動
slid=slide的過去式或過去分詞;滑動
slidden=slide的過去分詞;滑動
sow=播種
sowed=sow的過去式或過去分詞;播種
sown=sow的過去分詞;播種
speak=講話
spoke=speak的過去式或過去分詞;講話
spoken=speak的過去分詞;講話
speed=迅速前進
sped=speed的過去式或過去分詞;迅速前進
speeded=speed的過去式或過去分詞;迅速前進
spill=使溢出
spilt=spill的過去式或過去分詞;使溢出
spin=紡,吐絲
span=spin的過去式;紡,吐絲
spun=spin的過去式或過去分詞;紡,吐絲
spit=吐(唾液等);可用於現在式、過去式或過去分詞
split=劈開;可用於現在式、過去式或過去分詞
spread=張開,傳播;可用於現在式、過去式或過去分詞
spring=跳,彈起
sprang=spring的過去式;跳,彈起
sprung=spring的過去式或過去分詞;跳,彈起
stand=站立
stood=stand的過去式或過去分詞;站立
steal=偷竊
stole=steal的過去式;偷竊
stolen=steal的過去分詞;偷竊
stick=刺死,插牢
stuck=stick的過去式或過去分詞;刺死,插牢
sting=刺,螫
stung=sting的過去式或過去分詞;刺,螫
strive=努力,奮鬥
strove=strive的過去式或過去分詞;努力,奮鬥
swear=發誓
swore=swear的過去式;發誓
sworn=swear的過去分詞;發誓
sweep=打掃
swept=sweep的過去式或過去分詞;打掃
write=寫
wrote=write的過去式;寫
written=write的過去分詞;寫
writ=write的過去式或過去分詞;寫
swim=游泳
swam=swim的過去式;游泳
swun=swim的過去分詞;游泳
swing=搖擺
swung=swing的過去式或過去分詞;搖擺
take=拿
took=take的過去式;拿
taken=take的過去分詞;拿
teach=教
taught=teach的過去式或過去分詞;教
tear=撕
tore=tear的過去式;撕
torn=tear的過去分詞;撕
tell=告訴
told=tell的過去式或過去分詞;告訴
think=想,認為
thought=think的過去式或過去分詞;想,認為
throw=丟棄
threw=throw的過去式;丟棄
thrown=throw的過去分詞;丟棄
thrust=用力推;可用於現在式、過去式或過去分詞
tread=踩,踏
trod=tread的過去式或過去分詞;踩,踏
trode=tread的過去式;踩,踏
trodden=tread的過去分詞;踩,踏
typewrite=打字
typewrote=typewrite的過去式;打字
typewritten=typewrite的過去分詞;打字
unbend=伸直
unbent=unbend的過去式或過去分詞;伸直
unbended=unbend的過去式或過去分詞;伸直
unbind=解放
unbound=unbind的過去式或過去分詞;解放
underbid=以低於實質的報價出價;可用於現在式、過去式或過去分詞
underbidden=underbid的過去分詞;以低於實質的報價出價
undergo=經歷,接受(治療)
underwent=undergo的過去式;經歷,接受(治療)
undergone=undergo的過去分詞;經歷,接受(治療)
underlay=墊,支撐;underlie的過去式,位於…之下
underlaid=underlay的過去式或過去分詞;墊,支撐
underlet=廉價出租;可用於現在式、過去式或過去分詞
underlie=位於…之下
underlain=underlie的過去分詞;位於…之下
understand=了解
understood=understand的過去式或過去分詞;了解
undertake=承擔,進行
undertook=undertake的過去式;承擔,進行
undertaken=undertake的過去分詞;承擔,進行
underwrite=簽名,投保險
underwrote=underwrite的過去式;簽名,投保險
underwritten=underwrite的過去分詞;簽名,投保險
undo=使恢復原狀
undid=undo的過去式;使恢復原狀
undone=undo的過去分詞;使恢復原狀
uphold=舉起
upheld=uphold的過去式或過去分詞;舉起
upset=打亂,打翻;可用於現在式、過去式或過去分詞
wake=醒來
waked=wake的過去式或過去分詞;醒來
woke=wake的過去式;醒來
waken=wake的過去分詞;醒來
wear=穿
wore=wear的過去式;穿
worn=wear的過去分詞;穿
weave=編織
wove=weave的過去式或過去分詞;編織
woven=weave的過去分詞;編織
weep=哭泣
wept=weep的過去式或過去分詞;哭泣
win=贏得
won=win的過去式或過去分詞;贏得
wind=轉動(把手),蜿蜒
wound=wind的過去式或過去分詞;轉動(把手),蜿蜒
withdraw=抽回,撤銷
withdrew=withdraw的過去式;抽回,撤銷
withdrawn=withdraw的過去分詞;抽回,撤銷
withhold=抑制,隱瞞
withheld=withhold的過去式或過去分詞;抑制,隱瞞
withstand=抵擋,反抗,禁得起
withstood=withstand的過去式或過去分詞;抵擋,反抗,禁得起
