arise=起来,上升
arose=arise的过去式;起来,上升
arisen=arise的过去分词;起来,上升
awake=唤醒
awoke=awake的过去式或过去分词;唤醒
awaked=awake的过去分词;唤醒
be=正在…,是;(am,is,are,…)的原形
am=第一人称单数现在式;正在…,是
is=第三人称单数现在式;正在…,是
are=第二人称单复数现在式,第一、三人称复数现在式;正在…,是
was=be的单数过去式;正在…,是
were=be的复数过去式;正在…,是
been=be的过去分词;正在…,是
bear=忍耐
bore=bear的过去式;忍耐
born=bear的过去分词;生
borne=bear的过去分词;忍耐
beat=打,击败;可用于现在式、过去式或过去分词
beaten=beat的过去分词;打,击败
become=变成;可用于现在式或过去分词
became=become的过去式;变成
begin=开始
began=begin的过去式;开始
begun=begin的过去分词;开始
behold=看,将…视为
beheld=behold的过去式或过去分词;看,将…视为
bend=弯曲,屈服
bent=bend的过去式或过去分词;弯曲,屈服
bended=bend的过去式或过去分词;弯曲,屈服
bereave=剥夺
bereaved=bereave的过去式或过去分词;剥夺
bereft=bereave的过去式或过去分词;剥夺
beseech=恳求;可用于现在式、过去式或过去分词
besought=beseech的过去式或过去分词;恳求
beset=包围;可用于现在式、过去式或过去分词
bet=打赌;可用于现在式、过去式或过去分词
betted=bet的过去式或过去分词;打赌
bid=嘱咐,出价;可用于现在式、过去式或过去分词
bade=bid的过去式;嘱咐,出价
bidden=bid的过去分词;嘱咐,出价
bide=居住
bode=bide的过去式;居住
bided=bide的过去式或过去分词;居住
bind=缚,绑
bound=bind的过去式或过去分词;缚,绑
bounden=bind的过去分词;缚,绑
bite=咬
bit=bite的过去式或过去分词;咬
bitten=bite的过去分词;咬
bleed=流血
bled=bleed的过去式或过去分词;流血
blend=混合,混杂
blended=blend的过去式或过去分词;混合,混杂
blent=blend的过去式或过去分词;混合,混杂
blow=吹
blew=blow的过去式;吹
blown=blow的过去分词;吹
break=打破,破裂
broke=break的过去式;打破,破裂
broken=break的过去分词;打破,破裂
breed=生育,饲养
bred=breed的过去式或过去分词;生育,饲养
bring=带来
brought=bring的过去式或过去分词;带来
broadcast=广播;可用于现在式、过去式或过去分词
broadcasted=broadcast的过去式或过去分词;广播
build=建造
built=build的过去式或过去分词;建造
burn=燃烧
burned=burn的过去式或过去分词;燃烧
burnt=burn的过去式或过去分词;燃烧
burst=爆炸,突然发生;可用于现在式、过去式或过去分词
buy=买
bought=buy的过去式或过去分词;买
cast=投,掷;可用于现在式、过去式或过去分词
catch=接住,赶上
caught=catch的过去式或过去分词;接住,赶上
chide=责骂,咆哮
chid=chide的过去式或过去分词;责骂,咆哮
chided=chide的过去式或过去分词;责骂,咆哮
chidden=chide的过去分词;责骂,咆哮
choose=选择
chose=choose的过去式;选择
chosen=choose的过去分词;选择
cleave=劈开,劈,执着
clove=cleave的过去式;劈开
clave=cleave的过去式;劈,执着
cleft=cleave的过去式或过去分词;劈开
cleaved=cleave的过去式或过去分词;劈开
cloven=cleave的过去分词;劈开
cling=黏着,依附
clung=cling的过去式或过去分词;黏着,依附
come=来;可用于现在式或过去分词
came=come的过去式;来
cost=花费;可用于现在式、过去式或过去分词
creep=蹑手蹑足地走,爬行
crept=creep的过去式或过去分词;蹑手蹑足地走,爬行
cut=切;可用于现在式、过去式或过去分词
deal=处理,发牌
dealt=deal的过去式或过去分词;处理,发牌
dig=挖,发掘
dug=dig的过去式或过去分词;挖,发掘
digged=dig的过去式或过去分词;挖,发掘
do=做
does=做(第三人称单数)
did=do或does的过去式;做
done=do或does的过去分词;做
draw=画,拖拉
drew=draw的过去式;画,拖拉
drawn=draw的过去分词;画,拖拉
drink=喝
drank=drink的过去式;喝
drunk=drink的过去分词;喝
drunken=drink的过去分词;喝
drive=开车
drove=drive的过去式;开车
driven=drive的过去分词;开车
dwell=居住
dwelt=dwell的过去式或过去分词;居住
eat=吃
ate=eat的过去式;吃
eaten=eat的过去分词;吃
fall=掉落
fell=fall的过去式;掉落
fallen=fall的过去分词;掉落
feed=喂食
fed=feed的过去式或过去分词;喂食
feel=感觉
felt=feel的过去式或过去分词;感觉
fight=打架,与…作战
fought=fight的过去式或过去分词;打架,与…作战
find=发现
found=find的过去式或过去分词;发现
flee=逃走
fled=flee的过去式或过去分词;逃走
fling=扔,掷
flung=fling的过去式或过去分词;扔,掷
fly=飞
flew=fly的过去式;飞
fiown=fly的过去分词;飞
forbear=节制
forbore=forbear的过去式;节制
forborne=forbear的过去分词;节制
forbid=禁止
forbade=forbid的过去式;禁止
forbidden=forbid的过去分词;禁止
forecast=预测,预知;可用于现在式、过去式或过去分词
forecasted=forecast的过去式或过去分词;预测,预知
forego=前行,居先
forewent=forego的过去式;前行,居先
forgone=forego的过去分词;前行,居先
foreknow=预知
foreknew=foreknow的过去式;预知
forknown=foreknow的过去分词;预知
foresee=预知,看穿
foresaw=foresee的过去式;预知,看穿
foreseen=foresee的过去分词;预知,看穿
foretell=预言
foretold=foretell的过去式或过去分词;预言
forget=忘记
forgot=forget的过去式或过去分词;忘记
forgotten=forget的过去分词;忘记
forgive=原谅
forgave=forgive的过去式;原谅
forgiven=forgive的过去分词;原谅
forsake=抛弃,离开
forsook=forsake的过去式;抛弃,离开
forsaken=forsake的过去分词;抛弃,离开
freeze=结冰,冻僵
froze=freeze的过去式;结冰,冻僵
frozen=freeze的过去分词;结冰,冻僵
get=得到,捉住
got=get的过去式或过去分词;得到,捉住
gotten=get的过去分词;得到,捉住
give=给
gave=give的过去式;给
given=give的过去分词;给
go=去
went=go的过去式;去
gone=go的过去分词;去
grind=磨碎
ground=grind的过去式或过去分词;磨碎
grow=生长,种植
grew=grow的过去式;生长,种植
grown=grow的过去分词;生长,种植
hang=挂起;吊死
hung=hang的过去式或过去分词;挂起
hanged=hang的过去式或过去分词;吊死
hear=听到
heard=hear的过去式或过去分词;听到
hide=躲藏
hid=hide的过去式或过去分词;躲藏
hidden=hide的过去分词;躲藏
hit=打击;可用于现在式、过去式或过去分词
hold=举行,紧握
held=hold的过去式或过去分词;举行,紧握
holden=hold的过去分词;举行,紧握
hurt=伤害;可用于现在式、过去式或过去分词
keep=保持
kept=keep的过去式或过去分词;保持
knit=编织;可用于现在式、过去式或过去分词
knitted=knit的过去式或过去分词;编织
know=知道,认识
knew=know的过去式;知道,认识
known=know的过去分词;知道,认识
lay=铺,下蛋;lie的过去式,躺
laid=lay的过去式或过去分词;铺,下蛋
lead=引导
led=lead的过去式或过去分词;引导
leave=离开
left=leave的过去式或过去分词;离开
lend=借出
lent=lend的过去式或过去分词;借出
let=让;可用于现在式、过去式或过去分词
lie=躺
lain=lie的过去分词;躺
light=点(火);可用于现在式、过去式或过去分词
lit=light的过去式或过去分词;点(火)
lose=丧失
lost=lose的过去式或过去分词;丧失
make=制作,让
made=make的过去式或过去分词;制作,让
mean=意指
meant=mean的过去式或过去分词;意指
meet=遇见
met=meet的过去式或过去分词;遇见
mislead=误导
misled=mislead的过去式或过去分词;误导
misread=读错;可用于现在式、过去式或过去分词
misspell=拼错
misspelled=misspell的过去式或过去分词;拼错
misspelt=misspell的过去式或过去分词;拼错
mistake=弄错
mistook=mistake的过去式;弄错
mistaken=mistake的过去分词;弄错
misunderstand=误解
misunderstood=misunderstand的过去式或过去分词;误解
outbid=报价上战胜;可用于现在式、过去式或过去分词
outbade=outbid的过去式;报价上战胜
outbidden=outbid的过去分词;报价上战胜
outdo=优于,抢先
outdid=outdo的过去式;优于,抢先
outdone=outdo的过去分词;优于,抢先
outgo=优于,比…更快速
outwent=outgo的过去式;优于,比…更快速
outgone=outgo的过去分词;优于,比…更快速
outgrow=比…生长更大或快
outgrew=outgrow的过去式;比…生长更大或快
outgrown=outgrow的过去分词;比…生长更大或快
outrun=跑的更快,超越;可用于现在式或过去分词
outran=outrun的过去式;跑的更快,超越
outsell=在推销上胜过…
outsold=outsell的过去式或过去分词;在推销上胜过…
outshine=光亮强过…
outshone=outshine的过去式或过去分词;光亮强过…
outspread=扩张,展开;可用于现在式、过去式或过去分词
outwear=用旧,穿破
outwore=outwear的过去式;用旧,穿破
outworn=outwear的过去分词;用旧,穿破
overcast=使沮丧,变多云;可用于现在式、过去式或过去分词
overcome=克服;可用于现在式或过去分词
overcame=overcome的过去式;克服
overdo=过度,夸张
overdid=overdo的过去式;过度,夸张
overdone=overdo的过去分词;过度,夸张
overdraw=过度,夸张
overdrew=overdraw的过去式;过度,夸张
overdrawn=overdraw的过去分词;过度,夸张
overdrink=饮过量
overdrank=overdrink的过去式;饮过量
overdrunk=overdrink的过去分词;饮过量
overeat=吃过量
overate=overeat的过去式;吃过量
overeaten=overeat的过去分词;吃过量
overfeed=吃得太多
overfed=overfeed的过去式或过去分词;吃得太多
overgrow=过度生长
overgrew=overgrow的过去式;过度生长
overgrown=overgrow的过去分词;过度生长
overhang=悬于…之上,迫近
overhung=overhang的过去式或过去分词;悬于…之上,迫近
overhear=无意中听到
overheard=overhear的过去式或过去分词;无意中听到
overlay=覆盖,镀;overlie的过去式;躺在…上面
overlaid=overlay的过去式或过去分词;覆盖,镀
overlie=躺在…上面
overlain=overlie的过去分词;躺在…上面
overpay=报酬给予过多
overpaid=overpay的过去式或过去分词;报酬给予过多
override=撤销,践踏
overrode=override的过去式;撤销,践踏
overridden=override的过去分词;撤销,践踏
overrun=横行于,泛滥;可用于现在式、过去式或过去分词
oversee=监督,瞭望
oversaw=oversee的过去式;监督,瞭望
overseen=oversee的过去分词;监督,瞭望
oversleep=睡过头
overslept=oversleep的过去式或过去分词;睡过头
overspend=过度使用,花费过多
overspent=overspend的过去式或过去分词;过度使用,花费过多
overspread=扩张,蔓延;可用于现在式、过去式或过去分词
overtake=追上,压倒
overtook=overtake的过去式;追上,压倒
overtaken=overtake的过去分词;追上,压倒
overthrow=打倒,
overthrew=overthrow的过去式;打倒,
overthrown=overthrow的过去分词;打倒,
pay=支付
paid=pay的过去式或过去分词;支付
plead=为…辩护;可用于现在式、过去式或过去分词
pleaded=plead的过去式或过去分词;为…辩护
pled=plead的过去式或过去分词;为…辩护
prepay=预付
prepaid=prepay的过去式或过去分词;预付
prove=证明
proved=prove的过去式或过去分词;证明
proven=prove的过去分词;证明
put=放;可用于现在式、过去式或过去分词
quit=停止;可用于现在式、过去式或过去分词
read=读;可用于现在式、过去式或过去分词
rebuild=重建,改建
rebuilt=rebuild的过去式或过去分词;重建,改建
recast=重新计算;可用于现在式、过去式或过去分词
relay=供给新材料;可用于现在式、过去式或过去分词
rend=割裂,爆开
rent=rend的过去式或过去分词;割裂,爆开
repay=还钱,偿还
repaid=repay的过去式或过去分词;还钱,偿还
reread=重读;可用于现在式、过去式或过去分词
resell=再卖,转售重换
resold=resell的过去式或过去分词;再卖,转售重换
reset=重换;可用于现在式、过去式或过去分词
retell=重复
retold=retell的过去式或过去分词;重复
rid=使免除;可用于现在式、过去式或过去分词 
ride=骑
rode=ride的过去式;骑
ridden=ride的过去分词;骑
ring=响(铃)
rang=ring的过去式;响(铃)
rung=ring的过去分词;响(铃)
rise=上升(太阳),起床
rose=rise的过去式;上升(太阳),起床
risen=rise的过去分词;上升(太阳),起床
run=跑;可用于现在式或过去分词
ran =run的过去式;跑
saw=锯开;see(看)的过去式
sawed=saw的过去式或过去分词;锯开
sawn=saw的过去分词;锯开
say=说
said=say的过去式或过去分词;说
see=看
seen=see的过去分词;看
seek=寻找
sought=seek的过去式或过去分词;寻找
sell=卖
sold=sell的过去式或过去分词;卖
send=送;可用于现在式、过去式或过去分词
set=设定,放置;可用于现在式、过去式或过去分词
sew=缝合
sewed=sew的过去式或过去分词;缝合
sewn=sew的过去分词;缝合
shake=摇动
shook=shake的过去式;摇动
shaken=shake的过去分词;摇动
shave=刮(胡子等)
shaved=shave的过去式或过去分词;刮(胡子等)
shaven=shave的过去分词;刮(胡子等)
shed=流出,散发;可用于现在式、过去式或过去分词
shine=照耀,发亮
shone=shine的过去式或过去分词;照耀,发亮
shoot=发射
shot=shoot的过去式或过去分词;发射
sit=坐
sat=sit的过去式或过去分词;坐
slay=杀死
slew=slay的过去式;杀死
slain=slay的过去分词;杀死
sleep=睡觉
slept=sleep的过去式或过去分词;睡觉
slide=滑动
slid=slide的过去式或过去分词;滑动
slidden=slide的过去分词;滑动
sow=播种
sowed=sow的过去式或过去分词;播种
sown=sow的过去分词;播种
speak=讲话
spoke=speak的过去式或过去分词;讲话
spoken=speak的过去分词;讲话
speed=迅速前进
sped=speed的过去式或过去分词;迅速前进
speeded=speed的过去式或过去分词;迅速前进
spill=使溢出
spilt=spill的过去式或过去分词;使溢出
spin=纺,吐丝
span=spin的过去式;纺,吐丝
spun=spin的过去式或过去分词;纺,吐丝
spit=吐(唾液等);可用于现在式、过去式或过去分词
split=劈开;可用于现在式、过去式或过去分词
spread=张开,传播;可用于现在式、过去式或过去分词
spring=跳,弹起
sprang=spring的过去式;跳,弹起
sprung=spring的过去式或过去分词;跳,弹起
stand=站立
stood=stand的过去式或过去分词;站立
steal=偷窃
stole=steal的过去式;偷窃
stolen=steal的过去分词;偷窃
stick=刺死,插牢
stuck=stick的过去式或过去分词;刺死,插牢
sting=刺,螫
stung=sting的过去式或过去分词;刺,螫
strive=努力,奋斗
strove=strive的过去式或过去分词;努力,奋斗
swear=发誓
swore=swear的过去式;发誓
sworn=swear的过去分词;发誓
sweep=打扫
swept=sweep的过去式或过去分词;打扫
write=写
wrote=write的过去式;写
written=write的过去分词;写
writ=write的过去式或过去分词;写
swim=游泳
swam=swim的过去式;游泳
swun=swim的过去分词;游泳
swing=摇摆
swung=swing的过去式或过去分词;摇摆
take=拿
took=take的过去式;拿
taken=take的过去分词;拿
teach=教
taught=teach的过去式或过去分词;教
tear=撕
tore=tear的过去式;撕
torn=tear的过去分词;撕
tell=告诉
told=tell的过去式或过去分词;告诉
think=想,认为
thought=think的过去式或过去分词;想,认为
throw=丢弃
threw=throw的过去式;丢弃
thrown=throw的过去分词;丢弃
thrust=用力推;可用于现在式、过去式或过去分词
tread=踩,踏
trod=tread的过去式或过去分词;踩,踏
trode=tread的过去式;踩,踏
trodden=tread的过去分词;踩,踏
typewrite=打字
typewrote=typewrite的过去式;打字
typewritten=typewrite的过去分词;打字
unbend=伸直
unbent=unbend的过去式或过去分词;伸直
unbended=unbend的过去式或过去分词;伸直
unbind=解放
unbound=unbind的过去式或过去分词;解放
underbid=以低于实质的报价出价;可用于现在式、过去式或过去分词
underbidden=underbid的过去分词;以低于实质的报价出价
undergo=经历,接受(治疗)
underwent=undergo的过去式;经历,接受(治疗)
undergone=undergo的过去分词;经历,接受(治疗)
underlay=垫,支撑;underlie的过去式,位于…之下
underlaid=underlay的过去式或过去分词;垫,支撑
underlet=廉价出租;可用于现在式、过去式或过去分词
underlie=位于…之下
underlain=underlie的过去分词;位于…之下
understand=了解
understood=understand的过去式或过去分词;了解
undertake=承担,进行
undertook=undertake的过去式;承担,进行
undertaken=undertake的过去分词;承担,进行
underwrite=签名,投保险
underwrote=underwrite的过去式;签名,投保险
underwritten=underwrite的过去分词;签名,投保险
undo=使恢复原状
undid=undo的过去式;使恢复原状
undone=undo的过去分词;使恢复原状
uphold=举起
upheld=uphold的过去式或过去分词;举起
upset=打乱,打翻;可用于现在式、过去式或过去分词
wake=醒来
waked=wake的过去式或过去分词;醒来
woke=wake的过去式;醒来
waken=wake的过去分词;醒来
wear=穿
wore=wear的过去式;穿
worn=wear的过去分词;穿
weave=编织
wove=weave的过去式或过去分词;编织
woven=weave的过去分词;编织
weep=哭泣
wept=weep的过去式或过去分词;哭泣
win=赢得
won=win的过去式或过去分词;赢得
wind=转动(把手),蜿蜒
wound=wind的过去式或过去分词;转动(把手),蜿蜒
withdraw=抽回,撤销
withdrew=withdraw的过去式;抽回,撤销
withdrawn=withdraw的过去分词;抽回,撤销
withhold=抑制,隐瞒
withheld=withhold的过去式或过去分词;抑制,隐瞒
withstand=抵挡,反抗,禁得起
withstood=withstand的过去式或过去分词;抵挡,反抗,禁得起
